data_somministrazione,area,totale,sesso_maschile,sesso_femminile,categoria_operatori_sanitari_sociosanitari,categoria_personale_non_sanitario,categoria_ospiti_rsa,categoria_over80,categoria_forze_armate,categoria_personale_scolastico,prima_dose,seconda_dose,codice_NUTS1,codice_NUTS2,codice_regione_ISTAT,nome_area
2021-02-06 00:00:00,TOS,4527,1550,2977,3725,575,227,0,0,0,1294,3233,ITI,ITI1,9,Toscana
2021-01-03 00:00:00,TOS,3336,1052,2284,2565,9,762,0,0,0,3336,0,ITI,ITI1,9,Toscana
2020-12-28 00:00:00,SAR,65,25,40,65,0,0,0,0,0,65,0,ITG,ITG2,20,Sardegna
2021-01-29 00:00:00,BAS,612,228,384,397,145,70,0,0,0,63,549,ITF,ITF5,17,Basilicata
2021-02-26 00:00:00,SAR,2788,1102,1686,1220,1068,218,203,74,5,2481,307,ITG,ITG2,20,Sardegna
2021-02-07 00:00:00,BAS,373,159,214,259,74,40,0,0,0,49,324,ITF,ITF5,17,Basilicata
2021-01-20 00:00:00,LAZ,4390,1657,2733,3279,399,426,286,0,0,2849,1541,ITI,ITI4,12,Lazio
2021-03-04 00:00:00,FVG,3397,1572,1825,357,250,88,1811,490,401,2764,633,ITH,ITH4,6,Friuli-Venezia Giulia
2021-03-02 00:00:00,LAZ,16505,7141,9364,1808,1421,229,8015,1278,3754,12576,3929,ITI,ITI4,12,Lazio
2021-03-12 00:00:00,CAM,14233,7084,7149,979,4700,82,5285,1234,1953,8153,6080,ITF,ITF3,15,Campania
2021-02-06 00:00:00,PAB,2299,1025,1274,446,375,6,1471,0,1,18,2281,ITH,ITH1,4,Provincia Autonoma Bolzano / Bozen
2021-03-03 00:00:00,PUG,16324,6543,9781,2013,816,192,5813,810,6680,14503,1821,ITF,ITF4,16,Puglia
2021-02-15 00:00:00,ABR,1796,831,965,625,487,221,217,246,0,1754,42,ITF,ITF1,13,Abruzzo
2021-03-05 00:00:00,EMR,17477,5679,11798,3063,1476,244,6249,531,5914,14083,3394,ITH,ITH5,8,Emilia-Romagna
2021-03-15 00:00:00,LOM,30672,10998,19674,4562,3810,814,12803,517,8166,22361,8311,ITC,ITC4,3,Lombardia
2021-01-18 00:00:00,CAM,957,399,558,576,194,187,0,0,0,713,244,ITF,ITF3,15,Campania
2021-02-23 00:00:00,SAR,1519,1010,509,602,521,89,6,301,0,1285,234,ITG,ITG2,20,Sardegna
2021-01-02 00:00:00,MAR,453,139,314,444,9,0,0,0,0,453,0,ITI,ITI3,11,Marche
2021-03-13 00:00:00,CAM,14255,6792,7463,342,4234,193,5318,1195,2973,8970,5285,ITF,ITF3,15,Campania
2021-02-19 00:00:00,LOM,13988,5346,8642,5525,1884,1095,4540,928,16,13349,639,ITC,ITC4,3,Lombardia
2021-02-26 00:00:00,TOS,10043,3815,6228,1557,1705,294,1787,1137,3563,8837,1206,ITI,ITI1,9,Toscana
2021-02-22 00:00:00,CAM,10613,3282,7331,512,2276,139,3867,0,3819,10351,262,ITF,ITF3,15,Campania
2021-01-10 00:00:00,LAZ,4039,1700,2339,3424,363,252,0,0,0,4039,0,ITI,ITI4,12,Lazio
2021-01-30 00:00:00,EMR,10037,3508,6529,7562,1706,769,0,0,0,143,9894,ITH,ITH5,8,Emilia-Romagna
2021-01-13 00:00:00,PUG,4533,1727,2806,3967,334,230,0,0,2,4533,0,ITF,ITF4,16,Puglia
2021-02-03 00:00:00,PAB,1445,457,988,615,441,321,68,0,0,5,1440,ITH,ITH1,4,Provincia Autonoma Bolzano / Bozen
2021-02-23 00:00:00,PUG,9290,4394,4896,1757,484,156,5480,398,1015,8832,458,ITF,ITF4,16,Puglia
2021-02-05 00:00:00,UMB,780,234,546,645,51,84,0,0,0,18,762,ITI,ITI2,10,Umbria
2021-02-15 00:00:00,MAR,973,413,560,544,428,1,0,0,0,960,13,ITI,ITI3,11,Marche
2021-03-18 00:00:00,VEN,11992,4876,7116,1263,2069,302,7499,20,839,6979,5013,ITH,ITH3,5,Veneto
2021-01-19 00:00:00,PIE,6421,2099,4322,3574,1299,1548,0,0,0,6412,9,ITC,ITC1,1,Piemonte
2021-02-11 00:00:00,LIG,1952,757,1195,1233,258,455,0,0,6,1091,861,ITC,ITC3,7,Liguria
2021-01-07 00:00:00,FVG,2091,718,1373,1759,222,110,0,0,0,2091,0,ITH,ITH4,6,Friuli-Venezia Giulia
2021-03-08 00:00:00,TOS,6247,2551,3696,4063,1732,177,63,204,8,1430,4817,ITI,ITI1,9,Toscana
2021-03-11 00:00:00,SAR,5743,2597,3146,1009,1061,416,2666,489,102,4526,1217,ITG,ITG2,20,Sardegna
2021-01-16 00:00:00,CAM,3369,1675,1694,1355,1641,373,0,0,0,3369,0,ITF,ITF3,15,Campania
2021-01-11 00:00:00,EMR,9321,3265,6056,6572,1482,1267,0,0,0,9321,0,ITH,ITH5,8,Emilia-Romagna
2021-03-15 00:00:00,VDA,361,122,239,20,45,10,215,6,65,159,202,ITC,ITC2,2,Valle d'Aosta / Vall√©e d'Aoste
2021-01-08 00:00:00,FVG,2322,747,1575,1680,246,396,0,0,0,2322,0,ITH,ITH4,6,Friuli-Venezia Giulia
2021-01-06 00:00:00,CAM,7652,3749,3903,5781,1571,300,0,0,0,7652,0,ITF,ITF3,15,Campania
2021-03-16 00:00:00,CAL,3766,1847,1919,459,1121,22,2076,58,30,2171,1595,ITF,ITF6,18,Calabria
2021-01-12 00:00:00,LOM,19688,6561,13127,13370,4664,1562,91,1,0,19688,0,ITC,ITC4,3,Lombardia
2021-03-16 00:00:00,CAM,8069,3512,4557,287,1807,60,5777,23,115,3755,4314,ITF,ITF3,15,Campania
2021-02-03 00:00:00,TOS,4221,1452,2769,3475,240,505,1,0,0,241,3980,ITI,ITI1,9,Toscana
2021-01-25 00:00:00,EMR,6413,2128,4285,5231,504,678,0,0,0,221,6192,ITH,ITH5,8,Emilia-Romagna
2021-02-26 00:00:00,PAB,1384,492,892,62,142,2,846,0,332,1354,30,ITH,ITH1,4,Provincia Autonoma Bolzano / Bozen
2021-01-22 00:00:00,TOS,2861,1063,1798,2022,81,758,0,0,0,525,2336,ITI,ITI1,9,Toscana
2021-02-05 00:00:00,VEN,8361,2531,5830,4271,1912,2162,7,5,4,1424,6937,ITH,ITH3,5,Veneto
2021-02-12 00:00:00,TOS,7606,2683,4923,3742,3272,188,2,402,0,7393,213,ITI,ITI1,9,Toscana
2021-02-08 00:00:00,CAM,5113,2449,2664,1388,2121,226,1378,0,0,4311,802,ITF,ITF3,15,Campania
2021-03-07 00:00:00,PUG,4856,1916,2940,930,236,2,1572,323,1793,4286,570,ITF,ITF4,16,Puglia
2021-03-06 00:00:00,PAB,3946,2069,1877,478,871,7,1953,256,381,3734,212,ITH,ITH1,4,Provincia Autonoma Bolzano / Bozen
2021-02-24 00:00:00,PUG,9733,4551,5182,1874,706,117,6115,365,556,9145,588,ITF,ITF4,16,Puglia
2021-02-17 00:00:00,SAR,1405,575,830,689,376,313,0,27,0,1330,75,ITG,ITG2,20,Sardegna
2021-03-06 00:00:00,SAR,2535,1046,1489,1086,922,405,7,79,36,852,1683,ITG,ITG2,20,Sardegna
2021-03-06 00:00:00,EMR,20275,5795,14480,2672,963,40,5859,517,10224,17583,2692,ITH,ITH5,8,Emilia-Romagna
2021-01-29 00:00:00,PUG,6188,2659,3529,5465,432,288,0,0,3,436,5752,ITF,ITF4,16,Puglia
2021-01-29 00:00:00,CAM,10052,4812,5240,6405,3388,259,0,0,0,47,10005,ITF,ITF3,15,Campania
2021-01-06 00:00:00,UMB,843,323,520,840,3,0,0,0,0,843,0,ITI,ITI2,10,Umbria
2021-03-05 00:00:00,ABR,5261,1937,3324,561,457,107,2582,202,1352,4564,697,ITF,ITF1,13,Abruzzo
2021-03-18 00:00:00,PAT,2136,892,1244,50,579,0,1504,2,1,1151,985,ITH,ITH2,4,Provincia Autonoma Trento
2021-01-05 00:00:00,LIG,2878,896,1982,2307,303,261,0,0,7,2878,0,ITC,ITC3,7,Liguria
2021-03-08 00:00:00,LOM,28759,10755,18004,6487,4018,1002,11158,1575,4519,21856,6903,ITC,ITC4,3,Lombardia
2021-03-02 00:00:00,TOS,10485,3741,6744,3169,1026,125,1820,833,3512,7048,3437,ITI,ITI1,9,Toscana
2021-03-16 00:00:00,EMR,11927,4872,7055,408,659,85,10645,6,124,4704,7223,ITH,ITH5,8,Emilia-Romagna
2021-02-03 00:00:00,MAR,2125,742,1383,1344,615,166,0,0,0,119,2006,ITI,ITI3,11,Marche
2021-01-22 00:00:00,EMR,1827,477,1350,941,164,722,0,0,0,1088,739,ITH,ITH5,8,Emilia-Romagna
2021-02-08 00:00:00,FVG,2354,693,1661,1399,521,434,0,0,0,91,2263,ITH,ITH4,6,Friuli-Venezia Giulia
2021-02-09 00:00:00,MOL,359,170,189,161,88,110,0,0,0,197,162,ITF,ITF2,14,Molise
2021-03-03 00:00:00,SAR,3741,2035,1706,1058,716,525,701,740,1,2603,1138,ITG,ITG2,20,Sardegna
2021-02-26 00:00:00,ABR,3919,1671,2248,1025,565,160,1650,257,262,2950,969,ITF,ITF1,13,Abruzzo
2021-02-12 00:00:00,PUG,4098,1629,2469,2937,451,690,5,10,5,3008,1090,ITF,ITF4,16,Puglia
2021-03-01 00:00:00,PAB,909,217,692,11,159,5,0,0,734,909,0,ITH,ITH1,4,Provincia Autonoma Bolzano / Bozen
2021-02-16 00:00:00,SAR,700,289,411,376,212,112,0,0,0,673,27,ITG,ITG2,20,Sardegna
2021-01-22 00:00:00,LOM,2891,814,2077,1545,610,727,9,0,0,2838,53,ITC,ITC4,3,Lombardia
2021-01-15 00:00:00,MAR,1771,500,1271,985,420,366,0,0,0,1771,0,ITI,ITI3,11,Marche
2021-02-27 00:00:00,PIE,12652,4839,7813,880,980,232,7526,0,3034,12304,348,ITC,ITC1,1,Piemonte
2021-03-15 00:00:00,SIC,10310,4512,5798,1237,2329,664,4830,213,1037,5239,5071,ITG,ITG1,19,Sicilia
2021-01-12 00:00:00,ABR,1804,666,1138,1470,334,0,0,0,0,1804,0,ITF,ITF1,13,Abruzzo
2021-03-01 00:00:00,VEN,9358,3699,5659,2013,1138,923,2628,156,2500,7533,1825,ITH,ITH3,5,Veneto
2021-01-04 00:00:00,MAR,1500,563,937,1290,199,11,0,0,0,1500,0,ITI,ITI3,11,Marche
2021-02-12 00:00:00,ABR,968,319,649,438,220,310,0,0,0,779,189,ITF,ITF1,13,Abruzzo
2021-01-03 00:00:00,MAR,896,348,548,759,137,0,0,0,0,896,0,ITI,ITI3,11,Marche
2021-01-24 00:00:00,TOS,3348,1072,2276,2601,37,709,1,0,0,200,3148,ITI,ITI1,9,Toscana
2021-03-12 00:00:00,LOM,33217,12317,20900,4957,3935,1352,15260,1073,6640,23255,9962,ITC,ITC4,3,Lombardia
2021-03-18 00:00:00,CAL,4240,1978,2262,359,1365,232,2195,44,45,2271,1969,ITF,ITF6,18,Calabria
2021-03-10 00:00:00,UMB,3970,1900,2070,120,858,144,2564,209,75,2683,1287,ITI,ITI2,10,Umbria
2021-02-08 00:00:00,LOM,9779,2855,6924,5181,2234,2311,53,0,0,2077,7702,ITC,ITC4,3,Lombardia
2021-01-09 00:00:00,SAR,4026,1417,2609,3181,845,0,0,0,0,4026,0,ITG,ITG2,20,Sardegna
2021-01-15 00:00:00,LIG,2245,751,1494,1323,408,512,0,0,2,2245,0,ITC,ITC3,7,Liguria
2021-01-29 00:00:00,SAR,2951,1067,1884,2580,368,3,0,0,0,48,2903,ITG,ITG2,20,Sardegna
2021-03-09 00:00:00,PIE,13523,5256,8267,1679,1560,354,7615,0,2315,11176,2347,ITC,ITC1,1,Piemonte
2021-03-15 00:00:00,MAR,4489,2109,2380,300,473,8,3453,14,241,1422,3067,ITI,ITI3,11,Marche
2020-12-27 00:00:00,CAM,720,422,298,703,17,0,0,0,0,720,0,ITF,ITF3,15,Campania
2021-01-28 00:00:00,SIC,9328,4399,4929,7464,1569,295,0,0,0,414,8914,ITG,ITG1,19,Sicilia
2021-03-14 00:00:00,MOL,594,239,355,2,592,0,0,0,0,16,578,ITF,ITF2,14,Molise
2021-01-29 00:00:00,PIE,5939,1886,4053,4198,1069,672,0,0,0,455,5484,ITC,ITC1,1,Piemonte
2021-02-17 00:00:00,PIE,4730,2124,2606,2187,2044,497,1,0,1,3741,989,ITC,ITC1,1,Piemonte
2021-02-08 00:00:00,CAL,1847,733,1114,1214,512,121,0,0,0,661,1186,ITF,ITF6,18,Calabria
2021-03-16 00:00:00,SIC,10168,4462,5706,1662,1733,810,5677,68,218,4016,6152,ITG,ITG1,19,Sicilia
2021-03-06 00:00:00,ABR,4174,1354,2820,432,368,52,1748,15,1559,3604,570,ITF,ITF1,13,Abruzzo
2021-03-08 00:00:00,CAL,5312,2815,2497,707,1813,453,1514,822,3,4254,1058,ITF,ITF6,18,Calabria
2021-01-24 00:00:00,LAZ,5467,2109,3358,4945,262,134,126,0,0,385,5082,ITI,ITI4,12,Lazio
2021-01-27 00:00:00,PUG,4574,1927,2647,3915,261,396,0,0,2,610,3964,ITF,ITF4,16,Puglia
2021-03-03 00:00:00,FVG,3622,1617,2005,748,558,100,1320,469,427,2346,1276,ITH,ITH4,6,Friuli-Venezia Giulia
2021-01-05 00:00:00,VEN,7327,2183,5144,5410,789,1122,0,1,5,7327,0,ITH,ITH3,5,Veneto
2021-01-30 00:00:00,SIC,7837,3569,4268,5450,1912,475,0,0,0,175,7662,ITG,ITG1,19,Sicilia
2021-03-13 00:00:00,ABR,4124,1420,2704,518,988,137,1401,23,1057,3081,1043,ITF,ITF1,13,Abruzzo
2021-02-14 00:00:00,LAZ,5535,2245,3290,1645,318,127,3445,0,0,5286,249,ITI,ITI4,12,Lazio
2020-12-27 00:00:00,PUG,506,249,257,401,42,63,0,0,0,506,0,ITF,ITF4,16,Puglia
2021-03-12 00:00:00,ABR,6021,1988,4033,1005,875,135,1700,117,2189,4438,1583,ITF,ITF1,13,Abruzzo
2021-01-14 00:00:00,SIC,5250,2514,2736,3046,1945,259,0,0,0,5250,0,ITG,ITG1,19,Sicilia
2021-03-16 00:00:00,MAR,3577,1549,2028,317,196,54,2928,77,5,394,3183,ITI,ITI3,11,Marche
2021-03-02 00:00:00,CAM,12746,4550,8196,1266,4352,148,1938,2,5040,8402,4344,ITF,ITF3,15,Campania
2021-01-17 00:00:00,PIE,3517,1168,2349,2083,595,839,0,0,0,2870,647,ITC,ITC1,1,Piemonte
2021-01-06 00:00:00,CAL,926,500,426,822,104,0,0,0,0,926,0,ITF,ITF6,18,Calabria
2021-01-26 00:00:00,PIE,6328,1878,4450,4725,875,728,0,0,0,735,5593,ITC,ITC1,1,Piemonte
2021-02-12 00:00:00,UMB,671,224,447,459,208,1,1,0,2,665,6,ITI,ITI2,10,Umbria
2021-03-10 00:00:00,LIG,5685,2744,2941,814,778,85,3602,405,1,3788,1897,ITC,ITC3,7,Liguria
2021-01-20 00:00:00,VEN,1039,368,671,696,130,213,0,0,0,387,652,ITH,ITH3,5,Veneto
2021-03-06 00:00:00,LOM,20780,8838,11942,4716,5887,438,7381,1011,1347,16275,4505,ITC,ITC4,3,Lombardia
2021-01-10 00:00:00,TOS,3001,1104,1897,2432,138,431,0,0,0,3001,0,ITI,ITI1,9,Toscana
2021-01-18 00:00:00,LOM,9012,2927,6085,5149,2043,1764,54,2,0,8030,982,ITC,ITC4,3,Lombardia
2021-01-05 00:00:00,LOM,7673,2513,5160,6160,1334,172,7,0,0,7673,0,ITC,ITC4,3,Lombardia
2021-02-02 00:00:00,FVG,2466,806,1660,1657,393,416,0,0,0,217,2249,ITH,ITH4,6,Friuli-Venezia Giulia
2020-12-27 00:00:00,PAT,103,40,63,76,6,21,0,0,0,103,0,ITH,ITH2,4,Provincia Autonoma Trento
2021-03-08 00:00:00,LIG,5579,2440,3139,1120,527,80,3539,306,7,3894,1685,ITC,ITC3,7,Liguria
2021-01-19 00:00:00,EMR,2039,502,1537,745,135,1159,0,0,0,2022,17,ITH,ITH5,8,Emilia-Romagna
2021-01-18 00:00:00,EMR,3125,879,2246,1681,316,1128,0,0,0,2448,677,ITH,ITH5,8,Emilia-Romagna
2021-01-23 00:00:00,CAM,3839,2029,1810,3161,609,69,0,0,0,273,3566,ITF,ITF3,15,Campania
2021-03-17 00:00:00,CAM,11554,5082,6472,458,2058,43,8861,20,114,4980,6574,ITF,ITF3,15,Campania
2021-01-27 00:00:00,VEN,7140,2064,5076,5206,1047,879,0,0,8,246,6894,ITH,ITH3,5,Veneto
2021-01-16 00:00:00,ABR,927,428,499,710,202,15,0,0,0,927,0,ITF,ITF1,13,Abruzzo
2021-01-24 00:00:00,SIC,4335,2262,2073,3990,342,3,0,0,0,148,4187,ITG,ITG1,19,Sicilia
2021-01-26 00:00:00,UMB,814,390,424,813,1,0,0,0,0,18,796,ITI,ITI2,10,Umbria
2021-03-01 00:00:00,CAL,2688,1533,1155,399,422,257,971,636,3,2238,450,ITF,ITF6,18,Calabria
2021-02-02 00:00:00,SAR,1482,655,827,988,494,0,0,0,0,241,1241,ITG,ITG2,20,Sardegna
2021-02-22 00:00:00,LOM,11654,4713,6941,4164,1536,932,4029,965,28,11345,309,ITC,ITC4,3,Lombardia
2021-01-22 00:00:00,UMB,276,105,171,273,1,2,0,0,0,32,244,ITI,ITI2,10,Umbria
2021-02-22 00:00:00,MAR,3413,1498,1915,325,408,77,2596,5,2,3339,74,ITI,ITI3,11,Marche
2021-01-15 00:00:00,PAT,592,130,462,460,21,111,0,0,0,592,0,ITH,ITH2,4,Provincia Autonoma Trento
2021-01-31 00:00:00,UMB,1056,276,780,765,10,281,0,0,0,25,1031,ITI,ITI2,10,Umbria
2021-01-05 00:00:00,SAR,1327,446,881,1283,44,0,0,0,0,1327,0,ITG,ITG2,20,Sardegna
2021-01-03 00:00:00,UMB,267,111,156,267,0,0,0,0,0,267,0,ITI,ITI2,10,Umbria
2021-02-11 00:00:00,MAR,1988,658,1330,1155,621,212,0,0,0,1599,389,ITI,ITI3,11,Marche
2021-02-16 00:00:00,MOL,156,70,86,148,8,0,0,0,0,150,6,ITF,ITF2,14,Molise
2021-02-17 00:00:00,MOL,72,32,40,47,19,6,0,0,0,57,15,ITF,ITF2,14,Molise
2020-12-27 00:00:00,FVG,262,149,113,259,3,0,0,0,0,262,0,ITH,ITH4,6,Friuli-Venezia Giulia
2021-03-06 00:00:00,FVG,3487,1192,2295,182,259,1,1561,19,1465,3161,326,ITH,ITH4,6,Friuli-Venezia Giulia
2021-03-12 00:00:00,VDA,529,175,354,14,104,7,148,2,254,303,226,ITC,ITC2,2,Valle d'Aosta / Vall√©e d'Aoste
2021-01-20 00:00:00,SAR,210,77,133,154,56,0,0,0,0,208,2,ITG,ITG2,20,Sardegna
2021-02-07 00:00:00,MOL,66,32,34,49,1,16,0,0,0,19,47,ITF,ITF2,14,Molise
2020-12-27 00:00:00,SAR,65,34,31,65,0,0,0,0,0,65,0,ITG,ITG2,20,Sardegna
2021-01-12 00:00:00,VDA,302,72,230,242,49,11,0,0,0,302,0,ITC,ITC2,2,Valle d'Aosta / Vall√©e d'Aoste
2021-03-02 00:00:00,PAB,681,193,488,1,1,0,0,7,672,681,0,ITH,ITH1,4,Provincia Autonoma Bolzano / Bozen
2021-01-20 00:00:00,TOS,1314,635,679,432,256,626,0,0,0,1077,237,ITI,ITI1,9,Toscana
2021-02-03 00:00:00,LOM,25277,7842,17435,15485,5684,3957,142,8,1,1119,24158,ITC,ITC4,3,Lombardia
2021-02-26 00:00:00,EMR,7538,2855,4683,1008,622,217,5388,0,303,6502,1036,ITH,ITH5,8,Emilia-Romagna
2021-01-15 00:00:00,UMB,692,212,480,588,44,60,0,0,0,692,0,ITI,ITI2,10,Umbria
2021-03-04 00:00:00,CAL,5381,3104,2277,646,1413,731,1540,1049,2,4585,796,ITF,ITF6,18,Calabria
2021-03-05 00:00:00,PAB,1756,590,1166,337,383,28,760,9,239,1314,442,ITH,ITH1,4,Provincia Autonoma Bolzano / Bozen
2021-01-21 00:00:00,VEN,2290,719,1571,1985,162,141,0,0,2,21,2269,ITH,ITH3,5,Veneto
2021-01-08 00:00:00,PAT,1442,312,1130,764,152,526,0,0,0,1442,0,ITH,ITH2,4,Provincia Autonoma Trento
2021-03-05 00:00:00,SAR,4872,2392,2480,1643,1357,638,565,659,10,2656,2216,ITG,ITG2,20,Sardegna
2021-02-22 00:00:00,FVG,2492,1196,1296,431,326,115,1369,246,5,2074,418,ITH,ITH4,6,Friuli-Venezia Giulia
2021-02-20 00:00:00,MAR,4126,1708,2418,118,411,261,3333,3,0,4015,111,ITI,ITI3,11,Marche
2021-01-31 00:00:00,CAL,1107,554,553,764,285,58,0,0,0,155,952,ITF,ITF6,18,Calabria
2021-02-05 00:00:00,MOL,593,269,324,460,70,63,0,0,0,55,538,ITF,ITF2,14,Molise
2021-01-05 00:00:00,BAS,945,409,536,861,84,0,0,0,0,945,0,ITF,ITF5,17,Basilicata
2021-03-01 00:00:00,PAT,1235,453,782,74,18,10,1035,3,95,937,298,ITH,ITH2,4,Provincia Autonoma Trento
2021-01-04 00:00:00,ABR,1401,575,826,1396,5,0,0,0,0,1401,0,ITF,ITF1,13,Abruzzo
2021-01-27 00:00:00,BAS,410,174,236,299,85,26,0,0,0,113,297,ITF,ITF5,17,Basilicata
2021-03-11 00:00:00,ABR,5422,2186,3236,1322,558,241,1539,199,1563,4283,1139,ITF,ITF1,13,Abruzzo
2021-02-20 00:00:00,CAM,8565,3079,5486,1015,858,145,4582,0,1965,8262,303,ITF,ITF3,15,Campania
2021-01-03 00:00:00,LOM,852,316,536,744,103,4,1,0,0,852,0,ITC,ITC4,3,Lombardia
2021-02-24 00:00:00,TOS,10345,4457,5888,81,1570,301,4114,1331,2948,10148,197,ITI,ITI1,9,Toscana
2021-01-13 00:00:00,EMR,9062,2938,6124,6005,1312,1744,0,0,1,9062,0,ITH,ITH5,8,Emilia-Romagna
2021-03-10 00:00:00,VDA,436,182,254,9,68,17,336,6,0,225,211,ITC,ITC2,2,Valle d'Aosta / Vall√©e d'Aoste
2021-02-07 00:00:00,LAZ,4668,1865,2803,3251,385,218,813,0,1,382,4286,ITI,ITI4,12,Lazio
2021-02-15 00:00:00,SIC,3950,1861,2089,1699,1345,563,10,307,26,3381,569,ITG,ITG1,19,Sicilia
2021-02-09 00:00:00,PAT,914,287,627,447,13,73,381,0,0,441,473,ITH,ITH2,4,Provincia Autonoma Trento
2021-01-03 00:00:00,VEN,5158,1563,3595,4597,311,249,0,0,1,5158,0,ITH,ITH3,5,Veneto
2021-03-09 00:00:00,BAS,1391,706,685,222,95,33,545,258,238,787,604,ITF,ITF5,17,Basilicata
2021-02-10 00:00:00,CAM,6904,3413,3491,1945,2703,98,2158,0,0,6728,176,ITF,ITF3,15,Campania
2020-12-31 00:00:00,PUG,1634,782,852,1549,38,44,0,0,3,1634,0,ITF,ITF4,16,Puglia
2021-01-04 00:00:00,LOM,5977,2058,3919,4916,877,173,11,0,0,5977,0,ITC,ITC4,3,Lombardia
2021-01-20 00:00:00,PIE,6538,2067,4471,3571,1153,1814,0,0,0,5813,725,ITC,ITC1,1,Piemonte
2021-03-11 00:00:00,PIE,13519,4967,8552,2308,1444,369,7307,0,2091,10437,3082,ITC,ITC1,1,Piemonte
2021-02-03 00:00:00,VEN,5934,1659,4275,2852,1334,1743,1,0,4,482,5452,ITH,ITH3,5,Veneto
2021-02-12 00:00:00,CAL,1711,669,1042,815,760,136,0,0,0,943,768,ITF,ITF6,18,Calabria
2021-02-19 00:00:00,SIC,5153,2755,2398,1482,1363,599,74,1396,239,4585,568,ITG,ITG1,19,Sicilia
2021-01-11 00:00:00,SAR,1183,505,678,656,526,0,1,0,0,1183,0,ITG,ITG2,20,Sardegna
2021-03-16 00:00:00,MOL,594,225,369,13,566,11,0,4,0,247,347,ITF,ITF2,14,Molise
2021-02-06 00:00:00,EMR,7526,2379,5147,5358,946,1172,50,0,0,2120,5406,ITH,ITH5,8,Emilia-Romagna
2021-01-18 00:00:00,PUG,1844,770,1074,1182,216,446,0,0,0,1495,349,ITF,ITF4,16,Puglia
2021-02-17 00:00:00,TOS,8173,3168,5005,3465,1173,249,216,584,2486,7422,751,ITI,ITI1,9,Toscana
2021-01-28 00:00:00,LOM,12154,3683,8471,9171,1982,971,28,1,1,775,11379,ITC,ITC4,3,Lombardia
2021-01-25 00:00:00,SAR,588,212,376,553,35,0,0,0,0,22,566,ITG,ITG2,20,Sardegna
2021-02-25 00:00:00,FVG,3067,1603,1464,21,127,189,1556,433,741,3042,25,ITH,ITH4,6,Friuli-Venezia Giulia
2021-02-20 00:00:00,VDA,249,209,40,6,51,7,2,174,9,240,9,ITC,ITC2,2,Valle d'Aosta / Vall√©e d'Aoste
2021-01-06 00:00:00,PUG,3943,1664,2279,3221,349,373,0,0,0,3943,0,ITF,ITF4,16,Puglia
2021-03-14 00:00:00,CAM,8542,3734,4808,137,2215,36,3623,844,1687,4404,4138,ITF,ITF3,15,Campania
2021-01-09 00:00:00,UMB,1719,492,1227,888,10,821,0,0,0,1719,0,ITI,ITI2,10,Umbria
2021-02-08 00:00:00,LAZ,9334,3868,5466,3788,874,918,3754,0,0,4487,4847,ITI,ITI4,12,Lazio
2021-02-18 00:00:00,SIC,5494,3174,2320,1635,1244,813,9,1697,96,5063,431,ITG,ITG1,19,Sicilia
2021-01-02 00:00:00,BAS,949,380,569,855,91,0,0,0,3,949,0,ITF,ITF5,17,Basilicata
2021-01-05 00:00:00,PIE,5377,1602,3775,4364,728,285,0,0,0,5377,0,ITC,ITC1,1,Piemonte
2021-02-24 00:00:00,MAR,3440,1506,1934,226,235,165,2810,3,1,3361,79,ITI,ITI3,11,Marche
2021-02-01 00:00:00,PIE,8641,3053,5588,6164,1403,1074,0,0,0,578,8063,ITC,ITC1,1,Piemonte
2021-02-01 00:00:00,UMB,1260,333,927,876,32,352,0,0,0,47,1213,ITI,ITI2,10,Umbria
2021-01-04 00:00:00,PAB,469,191,278,397,72,0,0,0,0,469,0,ITH,ITH1,4,Provincia Autonoma Bolzano / Bozen
2021-02-28 00:00:00,LOM,7822,3229,4593,1106,2279,76,4248,82,31,7606,216,ITC,ITC4,3,Lombardia
2021-01-30 00:00:00,CAL,2173,1147,1026,1974,199,0,0,0,0,358,1815,ITF,ITF6,18,Calabria
2021-01-27 00:00:00,LAZ,5768,2170,3598,4797,385,457,129,0,0,651,5117,ITI,ITI4,12,Lazio
2021-02-28 00:00:00,MAR,2837,1250,1587,19,18,0,2796,2,2,2831,6,ITI,ITI3,11,Marche
2021-02-19 00:00:00,PIE,5526,2171,3355,1987,1765,666,30,0,1078,5024,502,ITC,ITC1,1,Piemonte
2021-01-04 00:00:00,TOS,5063,1893,3170,4099,32,932,0,0,0,5063,0,ITI,ITI1,9,Toscana
2021-03-03 00:00:00,TOS,17933,6370,11563,3318,1153,135,9062,819,3446,14336,3597,ITI,ITI1,9,Toscana
2021-01-25 00:00:00,UMB,647,322,325,645,2,0,0,0,0,5,642,ITI,ITI2,10,Umbria
2021-01-17 00:00:00,EMR,2889,887,2002,1913,425,547,0,0,4,2643,246,ITH,ITH5,8,Emilia-Romagna
2021-03-07 00:00:00,MOL,1114,499,615,2,1112,0,0,0,0,1112,2,ITF,ITF2,14,Molise
2021-01-24 00:00:00,PUG,1668,749,919,1286,231,150,1,0,0,152,1516,ITF,ITF4,16,Puglia
2021-03-15 00:00:00,VEN,16174,6949,9225,1343,2894,304,9289,397,1947,10983,5191,ITH,ITH3,5,Veneto
2021-02-15 00:00:00,LOM,8773,3070,5703,6010,1750,969,4,31,9,8353,420,ITC,ITC4,3,Lombardia
2021-01-07 00:00:00,LIG,3166,1076,2090,2313,420,428,0,1,4,3166,0,ITC,ITC3,7,Liguria
2021-02-17 00:00:00,SIC,5427,3290,2137,1528,1126,880,8,1883,2,4755,672,ITG,ITG1,19,Sicilia
2021-01-14 00:00:00,PAT,696,201,495,477,11,208,0,0,0,696,0,ITH,ITH2,4,Provincia Autonoma Trento
2021-01-12 00:00:00,CAM,5214,2563,2651,3439,1435,340,0,0,0,5214,0,ITF,ITF3,15,Campania
2020-12-31 00:00:00,EMR,2204,776,1428,1675,202,327,0,0,0,2204,0,ITH,ITH5,8,Emilia-Romagna
2021-03-11 00:00:00,TOS,14933,5752,9181,2436,2240,195,9885,165,12,11656,3277,ITI,ITI1,9,Toscana
2021-01-12 00:00:00,CAL,2058,1017,1041,1706,323,29,0,0,0,2058,0,ITF,ITF6,18,Calabria
2021-01-08 00:00:00,LIG,2926,999,1927,2084,406,431,0,1,4,2926,0,ITC,ITC3,7,Liguria
2021-01-02 00:00:00,UMB,301,110,191,301,0,0,0,0,0,301,0,ITI,ITI2,10,Umbria
2021-02-05 00:00:00,PIE,9449,3077,6372,5764,2041,1644,0,0,0,657,8792,ITC,ITC1,1,Piemonte
2021-03-17 00:00:00,ABR,4541,1875,2666,285,213,144,3871,17,11,2799,1742,ITF,ITF1,13,Abruzzo
2021-03-09 00:00:00,VEN,16175,7304,8871,1198,1914,668,8541,912,2942,10077,6098,ITH,ITH3,5,Veneto
2021-02-19 00:00:00,CAM,9556,3557,5999,1647,1128,161,4453,0,2167,8906,650,ITF,ITF3,15,Campania
2021-02-10 00:00:00,LAZ,7773,3113,4660,2646,580,633,3914,0,0,4838,2935,ITI,ITI4,12,Lazio
2021-03-05 00:00:00,PAT,2180,686,1494,125,130,101,903,157,764,1582,598,ITH,ITH2,4,Provincia Autonoma Trento
2021-01-31 00:00:00,LAZ,4279,1783,2496,3572,339,244,124,0,0,296,3983,ITI,ITI4,12,Lazio
2021-02-20 00:00:00,TOS,4641,1790,2851,3350,1038,203,17,15,18,4128,513,ITI,ITI1,9,Toscana
2021-02-28 00:00:00,ABR,1707,511,1196,23,34,0,79,149,1422,1705,2,ITF,ITF1,13,Abruzzo
2021-03-15 00:00:00,PAT,1372,529,843,62,494,7,592,54,163,908,464,ITH,ITH2,4,Provincia Autonoma Trento
2021-01-11 00:00:00,UMB,1271,336,935,878,20,373,0,0,0,1271,0,ITI,ITI2,10,Umbria
2021-03-09 00:00:00,UMB,4017,1943,2074,142,681,94,2912,165,23,2724,1293,ITI,ITI2,10,Umbria
2021-02-18 00:00:00,LOM,13935,4896,9039,6112,1944,1567,3427,857,28,12913,1022,ITC,ITC4,3,Lombardia
2021-03-10 00:00:00,BAS,1650,814,836,101,110,33,877,256,273,811,839,ITF,ITF5,17,Basilicata
2021-03-11 00:00:00,PAB,1643,806,837,89,551,68,365,237,333,1128,515,ITH,ITH1,4,Provincia Autonoma Bolzano / Bozen
2021-01-07 00:00:00,PAB,892,317,575,613,227,0,52,0,0,892,0,ITH,ITH1,4,Provincia Autonoma Bolzano / Bozen
2021-01-13 00:00:00,MOL,474,160,314,256,73,144,0,0,1,474,0,ITF,ITF2,14,Molise
2021-01-02 00:00:00,VEN,5740,1765,3975,4796,396,544,2,0,2,5740,0,ITH,ITH3,5,Veneto
2021-01-26 00:00:00,BAS,793,350,443,622,136,35,0,0,0,101,692,ITF,ITF5,17,Basilicata
2020-12-31 00:00:00,LOM,713,300,413,657,56,0,0,0,0,713,0,ITC,ITC4,3,Lombardia
2021-01-17 00:00:00,ABR,187,59,128,136,51,0,0,0,0,180,7,ITF,ITF1,13,Abruzzo
2021-01-24 00:00:00,FVG,305,119,186,277,27,1,0,0,0,1,304,ITH,ITH4,6,Friuli-Venezia Giulia
2021-01-30 00:00:00,PAT,383,130,253,345,7,31,0,0,0,151,232,ITH,ITH2,4,Provincia Autonoma Trento
2021-02-20 00:00:00,PAB,1502,471,1031,196,83,24,469,1,729,1484,18,ITH,ITH1,4,Provincia Autonoma Bolzano / Bozen
2021-02-23 00:00:00,MOL,527,202,325,136,42,8,340,0,1,362,165,ITF,ITF2,14,Molise
2021-01-08 00:00:00,LOM,12590,3893,8697,9956,2316,313,5,0,0,12590,0,ITC,ITC4,3,Lombardia
2021-03-05 00:00:00,PUG,16859,6717,10142,2306,1214,272,5191,1015,6861,14700,2159,ITF,ITF4,16,Puglia
2021-01-22 00:00:00,SAR,83,47,36,45,38,0,0,0,0,55,28,ITG,ITG2,20,Sardegna
2021-01-22 00:00:00,ABR,118,57,61,2,4,112,0,0,0,118,0,ITF,ITF1,13,Abruzzo
2021-03-14 00:00:00,UMB,66,48,18,0,61,1,0,0,4,66,0,ITI,ITI2,10,Umbria
2021-01-08 00:00:00,MOL,429,141,288,244,65,120,0,0,0,429,0,ITF,ITF2,14,Molise
2021-02-20 00:00:00,FVG,2068,933,1135,11,19,148,1584,0,306,1924,144,ITH,ITH4,6,Friuli-Venezia Giulia
2020-12-27 00:00:00,CAL,275,150,125,274,1,0,0,0,0,275,0,ITF,ITF6,18,Calabria
2021-01-30 00:00:00,VDA,436,202,234,232,192,12,0,0,0,13,423,ITC,ITC2,2,Valle d'Aosta / Vall√©e d'Aoste
2021-02-16 00:00:00,PAB,529,205,324,10,7,0,512,0,0,529,0,ITH,ITH1,4,Provincia Autonoma Bolzano / Bozen
2021-01-10 00:00:00,MOL,270,72,198,82,19,169,0,0,0,270,0,ITF,ITF2,14,Molise
2021-02-21 00:00:00,MOL,573,227,346,1,4,0,568,0,0,571,2,ITF,ITF2,14,Molise
2021-01-31 00:00:00,MOL,268,70,198,85,18,164,0,0,1,6,262,ITF,ITF2,14,Molise
2021-01-14 00:00:00,VDA,237,69,168,151,84,0,2,0,0,237,0,ITC,ITC2,2,Valle d'Aosta / Vall√©e d'Aoste
2021-02-13 00:00:00,PAT,536,333,203,373,5,0,158,0,0,171,365,ITH,ITH2,4,Provincia Autonoma Trento
2021-01-21 00:00:00,BAS,30,10,20,0,30,0,0,0,0,30,0,ITF,ITF5,17,Basilicata
2021-02-24 00:00:00,CAL,1843,940,903,658,366,115,653,47,4,1368,475,ITF,ITF6,18,Calabria
2021-02-16 00:00:00,VEN,6623,2867,3756,718,386,478,5039,1,1,6447,176,ITH,ITH3,5,Veneto
2021-02-22 00:00:00,VDA,316,94,222,62,41,37,103,6,67,213,103,ITC,ITC2,2,Valle d'Aosta / Vall√©e d'Aoste
2021-01-22 00:00:00,VEN,1079,332,747,946,76,57,0,0,0,25,1054,ITH,ITH3,5,Veneto
2021-01-28 00:00:00,LAZ,7954,2998,4956,6810,496,514,134,0,0,459,7495,ITI,ITI4,12,Lazio
2021-01-29 00:00:00,CAL,2048,984,1064,1752,247,49,0,0,0,234,1814,ITF,ITF6,18,Calabria
2021-02-12 00:00:00,PAT,1009,340,669,335,68,55,551,0,0,588,421,ITH,ITH2,4,Provincia Autonoma Trento
2021-02-17 00:00:00,VEN,6004,2764,3240,411,281,361,4946,5,0,5910,94,ITH,ITH3,5,Veneto
2021-03-12 00:00:00,FVG,3879,1527,2352,173,150,27,2840,100,589,2499,1380,ITH,ITH4,6,Friuli-Venezia Giulia
2021-01-24 00:00:00,MAR,891,342,549,772,119,0,0,0,0,17,874,ITI,ITI3,11,Marche
2021-03-10 00:00:00,LOM,31568,12065,19503,6741,4665,1860,11432,1524,5346,24047,7521,ITC,ITC4,3,Lombardia
2021-03-08 00:00:00,PIE,13716,5219,8497,2024,1415,366,7394,0,2517,11078,2638,ITC,ITC1,1,Piemonte
2021-03-05 00:00:00,BAS,1849,855,994,298,227,72,689,254,309,1104,745,ITF,ITF5,17,Basilicata
2021-03-06 00:00:00,UMB,4250,1109,3141,422,247,26,1113,120,2322,4107,143,ITI,ITI2,10,Umbria
2021-01-27 00:00:00,FVG,1269,425,844,849,356,64,0,0,0,447,822,ITH,ITH4,6,Friuli-Venezia Giulia
2021-03-04 00:00:00,VDA,291,139,152,55,58,2,160,14,2,42,249,ITC,ITC2,2,Valle d'Aosta / Vall√©e d'Aoste
2021-03-06 00:00:00,VEN,10500,4253,6247,2955,2715,1485,1973,46,1326,7306,3194,ITH,ITH3,5,Veneto
2021-01-30 00:00:00,LAZ,6649,2730,3919,5298,574,651,126,0,0,448,6201,ITI,ITI4,12,Lazio
2021-01-06 00:00:00,PAB,59,18,41,59,0,0,0,0,0,59,0,ITH,ITH1,4,Provincia Autonoma Bolzano / Bozen
2021-02-16 00:00:00,UMB,1307,655,652,33,12,0,1262,0,0,1298,9,ITI,ITI2,10,Umbria
2021-01-13 00:00:00,VDA,337,110,227,166,143,28,0,0,0,337,0,ITC,ITC2,2,Valle d'Aosta / Vall√©e d'Aoste
2021-02-13 00:00:00,ABR,845,383,462,549,224,72,0,0,0,437,408,ITF,ITF1,13,Abruzzo
2021-02-13 00:00:00,FVG,562,175,387,334,228,0,0,0,0,556,6,ITH,ITH4,6,Friuli-Venezia Giulia
2021-01-20 00:00:00,LIG,1450,529,921,693,330,425,0,0,2,1438,12,ITC,ITC3,7,Liguria
2021-01-29 00:00:00,VEN,8996,2780,6216,6039,1517,1434,3,1,2,367,8629,ITH,ITH3,5,Veneto
2021-03-01 00:00:00,SAR,2159,1054,1105,1135,444,141,104,334,1,1500,659,ITG,ITG2,20,Sardegna
2021-03-01 00:00:00,PIE,11696,4678,7018,1141,1277,281,6594,0,2403,10884,812,ITC,ITC1,1,Piemonte
2021-03-10 00:00:00,EMR,18072,7290,10782,1308,1216,106,9878,1114,4450,12456,5616,ITH,ITH5,8,Emilia-Romagna
2021-01-27 00:00:00,PAT,734,257,477,395,34,304,1,0,0,73,661,ITH,ITH2,4,Provincia Autonoma Trento
2021-01-27 00:00:00,CAL,1457,734,723,1226,208,23,0,0,0,396,1061,ITF,ITF6,18,Calabria
2021-02-28 00:00:00,MOL,828,331,497,38,763,27,0,0,0,786,42,ITF,ITF2,14,Molise
2021-01-25 00:00:00,BAS,1020,427,593,828,191,1,0,0,0,74,946,ITF,ITF5,17,Basilicata
2021-03-15 00:00:00,LAZ,19120,8277,10843,2290,3661,407,9530,706,2526,12434,6686,ITI,ITI4,12,Lazio
2021-03-13 00:00:00,MAR,5612,2506,3106,664,373,57,4248,133,137,1651,3961,ITI,ITI3,11,Marche
2021-01-29 00:00:00,PAT,1349,331,1018,722,86,541,0,0,0,54,1295,ITH,ITH2,4,Provincia Autonoma Trento
2021-02-02 00:00:00,LIG,2598,979,1619,1947,228,421,0,0,2,198,2400,ITC,ITC3,7,Liguria
2021-03-10 00:00:00,SAR,5643,2742,2901,719,868,413,2651,657,335,4790,853,ITG,ITG2,20,Sardegna
2021-03-18 00:00:00,PUG,7986,3575,4411,1700,473,152,5543,29,89,2557,5429,ITF,ITF4,16,Puglia
2021-02-06 00:00:00,FVG,1154,338,816,755,208,191,0,0,0,22,1132,ITH,ITH4,6,Friuli-Venezia Giulia
2021-01-13 00:00:00,SIC,5204,2462,2742,3033,1730,441,0,0,0,5204,0,ITG,ITG1,19,Sicilia
2021-02-24 00:00:00,MOL,666,278,388,242,105,44,274,0,1,333,333,ITF,ITF2,14,Molise
2021-03-04 00:00:00,BAS,1872,889,983,217,243,66,842,263,241,1079,793,ITF,ITF5,17,Basilicata
2021-02-10 00:00:00,PIE,7445,2346,5099,3847,1498,2100,0,0,0,1316,6129,ITC,ITC1,1,Piemonte
2021-03-04 00:00:00,SIC,15083,6501,8582,2811,2798,698,3927,1123,3726,10881,4202,ITG,ITG1,19,Sicilia
2021-03-05 00:00:00,SIC,15826,6817,9009,3190,2486,712,3998,1419,4021,11501,4325,ITG,ITG1,19,Sicilia
2021-02-23 00:00:00,SIC,8945,4687,4258,1265,1236,502,3996,1367,579,8456,489,ITG,ITG1,19,Sicilia
2021-01-16 00:00:00,LOM,15264,5688,9576,8555,5074,1480,152,3,0,15264,0,ITC,ITC4,3,Lombardia
2021-03-08 00:00:00,UMB,3665,1797,1868,140,355,45,2853,230,42,2303,1362,ITI,ITI2,10,Umbria
2021-02-17 00:00:00,CAL,1681,672,1009,673,343,285,299,0,81,1471,210,ITF,ITF6,18,Calabria
2021-02-17 00:00:00,PUG,4263,1742,2521,2453,1210,598,1,0,1,3666,597,ITF,ITF4,16,Puglia
2021-01-02 00:00:00,LAZ,6704,2629,4075,6268,78,358,0,0,0,6704,0,ITI,ITI4,12,Lazio
2020-12-27 00:00:00,VEN,880,395,485,875,4,0,0,0,1,880,0,ITH,ITH3,5,Veneto
2021-02-22 00:00:00,ABR,2644,1175,1469,477,357,46,1094,419,251,2614,30,ITF,ITF1,13,Abruzzo
2021-01-22 00:00:00,FVG,90,30,60,89,1,0,0,0,0,0,90,ITH,ITH4,6,Friuli-Venezia Giulia
2021-03-02 00:00:00,LIG,4036,1667,2369,723,176,76,3056,1,4,3726,310,ITC,ITC3,7,Liguria
2021-03-09 00:00:00,LAZ,20739,8893,11846,3359,2290,338,8905,1230,4617,15548,5191,ITI,ITI4,12,Lazio
2021-01-04 00:00:00,EMR,7258,2510,4748,6165,516,577,0,0,0,7258,0,ITH,ITH5,8,Emilia-Romagna
2021-02-02 00:00:00,VEN,6403,1843,4560,2970,1285,1994,152,0,2,392,6011,ITH,ITH3,5,Veneto
2021-03-12 00:00:00,EMR,17487,7153,10334,1575,1799,250,9750,1094,3019,10806,6681,ITH,ITH5,8,Emilia-Romagna
2021-03-14 00:00:00,PIE,8180,3322,4858,794,617,2,5794,0,973,5286,2894,ITC,ITC1,1,Piemonte
2021-01-12 00:00:00,MAR,1226,413,813,912,264,50,0,0,0,1226,0,ITI,ITI3,11,Marche
2021-02-19 00:00:00,BAS,1621,736,885,219,374,66,962,0,0,1559,62,ITF,ITF5,17,Basilicata
2021-01-27 00:00:00,SAR,1408,494,914,1303,105,0,0,0,0,79,1329,ITG,ITG2,20,Sardegna
2021-02-11 00:00:00,ABR,816,262,554,473,189,154,0,0,0,773,43,ITF,ITF1,13,Abruzzo
2021-02-20 00:00:00,BAS,1139,523,616,75,182,80,802,0,0,1022,117,ITF,ITF5,17,Basilicata
2021-01-08 00:00:00,BAS,554,219,335,383,112,59,0,0,0,554,0,ITF,ITF5,17,Basilicata
2021-03-01 00:00:00,LIG,3491,1421,2070,528,119,105,2738,0,1,3369,122,ITC,ITC3,7,Liguria
2021-01-14 00:00:00,LAZ,5217,1960,3257,3872,450,811,84,0,0,5217,0,ITI,ITI4,12,Lazio
2021-01-09 00:00:00,MOL,450,152,298,221,51,178,0,0,0,450,0,ITF,ITF2,14,Molise
2021-03-16 00:00:00,ABR,3486,1453,2033,284,166,169,2849,6,12,1831,1655,ITF,ITF1,13,Abruzzo
2021-02-03 00:00:00,EMR,9269,2972,6297,6227,1340,1617,85,0,0,953,8316,ITH,ITH5,8,Emilia-Romagna
2021-03-08 00:00:00,PAB,1187,517,670,23,285,164,712,0,3,1161,26,ITH,ITH1,4,Provincia Autonoma Bolzano / Bozen
2021-03-01 00:00:00,CAM,12115,4241,7874,1095,3709,145,1720,0,5446,8004,4111,ITF,ITF3,15,Campania
2021-02-04 00:00:00,CAM,7943,3429,4514,3965,3685,292,1,0,0,1308,6635,ITF,ITF3,15,Campania
2021-03-17 00:00:00,PIE,12112,4921,7191,2038,990,200,8875,0,9,4886,7226,ITC,ITC1,1,Piemonte
2021-02-04 00:00:00,PIE,10196,3337,6859,6234,2199,1763,0,0,0,588,9608,ITC,ITC1,1,Piemonte
2021-03-07 00:00:00,MAR,5183,2108,3075,607,357,0,3007,316,896,4430,753,ITI,ITI3,11,Marche
2021-01-31 00:00:00,PIE,4105,1748,2357,3076,654,375,0,0,0,112,3993,ITC,ITC1,1,Piemonte
2021-03-01 00:00:00,LOM,18511,8117,10394,2619,2606,871,10779,1608,28,16829,1682,ITC,ITC4,3,Lombardia
2021-03-04 00:00:00,LAZ,18152,7729,10423,2771,1551,506,8104,1315,3905,13148,5004,ITI,ITI4,12,Lazio
2021-01-03 00:00:00,EMR,2729,934,1795,2479,80,170,0,0,0,2729,0,ITH,ITH5,8,Emilia-Romagna
2021-01-20 00:00:00,UMB,613,222,391,583,15,14,0,0,1,613,0,ITI,ITI2,10,Umbria
2021-01-16 00:00:00,EMR,5592,1717,3875,3687,793,1108,0,3,1,5592,0,ITH,ITH5,8,Emilia-Romagna
2021-01-28 00:00:00,TOS,6275,1880,4395,5421,66,788,0,0,0,349,5926,ITI,ITI1,9,Toscana
2021-01-20 00:00:00,PAB,609,248,361,286,73,0,250,0,0,401,208,ITH,ITH1,4,Provincia Autonoma Bolzano / Bozen
2021-01-06 00:00:00,LOM,7044,2486,4558,5837,1167,38,0,0,2,7044,0,ITC,ITC4,3,Lombardia
2021-02-17 00:00:00,PAT,1104,423,681,324,27,35,703,3,12,1013,91,ITH,ITH2,4,Provincia Autonoma Trento
2021-02-14 00:00:00,BAS,151,48,103,55,13,65,18,0,0,151,0,ITF,ITF5,17,Basilicata
2021-03-16 00:00:00,VDA,175,35,140,2,42,13,118,0,0,114,61,ITC,ITC2,2,Valle d'Aosta / Vall√©e d'Aoste
2021-02-11 00:00:00,VDA,231,107,124,53,38,0,127,13,0,222,9,ITC,ITC2,2,Valle d'Aosta / Vall√©e d'Aoste
2021-01-07 00:00:00,SAR,3111,1077,2034,2720,380,0,0,11,0,3111,0,ITG,ITG2,20,Sardegna
2021-03-08 00:00:00,LAZ,19791,8187,11604,2418,2180,379,9004,1102,4708,14529,5262,ITI,ITI4,12,Lazio
2021-02-25 00:00:00,CAL,2821,1519,1302,736,636,234,863,348,4,2242,579,ITF,ITF6,18,Calabria
2021-01-22 00:00:00,PAB,241,138,103,129,23,85,3,0,1,124,117,ITH,ITH1,4,Provincia Autonoma Bolzano / Bozen
2021-01-16 00:00:00,PIE,7754,2630,5124,4794,1590,1370,0,0,0,7754,0,ITC,ITC1,1,Piemonte
2021-03-09 00:00:00,MAR,5519,2364,3155,754,468,36,2588,603,1070,4630,889,ITI,ITI3,11,Marche
2021-02-13 00:00:00,PIE,4149,1334,2815,2309,722,1112,1,0,5,2927,1222,ITC,ITC1,1,Piemonte
2021-01-18 00:00:00,PIE,6162,2047,4115,3233,1404,1525,0,0,0,5914,248,ITC,ITC1,1,Piemonte
2021-03-16 00:00:00,LOM,24851,9854,14997,3255,2870,1340,17294,17,75,16046,8805,ITC,ITC4,3,Lombardia
2021-01-13 00:00:00,SAR,573,178,395,494,79,0,0,0,0,573,0,ITG,ITG2,20,Sardegna
2020-12-29 00:00:00,LIG,125,33,92,93,11,21,0,0,0,125,0,ITC,ITC3,7,Liguria
2021-02-24 00:00:00,BAS,1803,743,1060,85,29,2,1686,1,0,1734,69,ITF,ITF5,17,Basilicata
2021-01-19 00:00:00,UMB,103,23,80,21,2,80,0,0,0,103,0,ITI,ITI2,10,Umbria
2021-01-01 00:00:00,LIG,144,55,89,139,5,0,0,0,0,144,0,ITC,ITC3,7,Liguria
2021-03-13 00:00:00,LIG,3521,1493,2028,328,710,72,1501,120,790,2668,853,ITC,ITC3,7,Liguria
2021-01-21 00:00:00,ABR,157,47,110,10,6,141,0,0,0,157,0,ITF,ITF1,13,Abruzzo
2021-02-07 00:00:00,ABR,777,307,470,646,130,1,0,0,0,201,576,ITF,ITF1,13,Abruzzo
2021-02-26 00:00:00,UMB,653,250,403,381,71,40,154,4,3,645,8,ITI,ITI2,10,Umbria
2021-01-07 00:00:00,UMB,1291,383,908,883,4,404,0,0,0,1291,0,ITI,ITI2,10,Umbria
2021-01-13 00:00:00,VEN,5975,1600,4375,2790,1300,1880,3,0,2,5975,0,ITH,ITH3,5,Veneto
2021-03-13 00:00:00,PAB,2859,1448,1411,165,1313,1,1272,89,19,2758,101,ITH,ITH1,4,Provincia Autonoma Bolzano / Bozen
2020-12-27 00:00:00,MOL,50,20,30,29,4,17,0,0,0,50,0,ITF,ITF2,14,Molise
2021-03-12 00:00:00,LIG,5876,2723,3153,1153,892,34,3356,437,4,3527,2349,ITC,ITC3,7,Liguria
2021-01-21 00:00:00,EMR,2151,725,1426,1282,216,653,0,0,0,809,1342,ITH,ITH5,8,Emilia-Romagna
2021-02-03 00:00:00,PIE,10185,3301,6884,6641,2309,1235,0,0,0,611,9574,ITC,ITC1,1,Piemonte
2021-03-07 00:00:00,CAL,3131,1561,1570,105,655,348,1674,347,2,3042,89,ITF,ITF6,18,Calabria
2021-02-12 00:00:00,PIE,6880,2211,4669,3523,1647,1708,0,0,2,3923,2957,ITC,ITC1,1,Piemonte
2021-03-11 00:00:00,VEN,19181,8547,10634,1547,3070,707,9309,964,3584,13794,5387,ITH,ITH3,5,Veneto
2021-02-05 00:00:00,PAB,2789,1036,1753,641,677,394,1077,0,0,6,2783,ITH,ITH1,4,Provincia Autonoma Bolzano / Bozen
2021-03-03 00:00:00,PAT,1636,617,1019,71,32,58,1255,19,201,1078,558,ITH,ITH2,4,Provincia Autonoma Trento
2021-01-07 00:00:00,VEN,8359,2319,6040,5467,1087,1805,0,0,0,8359,0,ITH,ITH3,5,Veneto
2021-02-21 00:00:00,MAR,377,142,235,204,115,57,0,0,1,376,1,ITI,ITI3,11,Marche
2021-02-26 00:00:00,VEN,8216,3241,4975,1675,1111,738,4379,31,282,6966,1250,ITH,ITH3,5,Veneto
2021-01-04 00:00:00,PIE,5562,1678,3884,4590,737,235,0,0,0,5562,0,ITC,ITC1,1,Piemonte
2021-01-04 00:00:00,UMB,809,397,412,808,1,0,0,0,0,809,0,ITI,ITI2,10,Umbria
2021-01-19 00:00:00,PAB,811,349,462,170,66,0,575,0,0,681,130,ITH,ITH1,4,Provincia Autonoma Bolzano / Bozen
2021-01-21 00:00:00,LOM,5319,1564,3755,3008,1283,1024,4,0,0,4632,687,ITC,ITC4,3,Lombardia
2021-02-11 00:00:00,CAL,2341,1043,1298,1464,636,241,0,0,0,1081,1260,ITF,ITF6,18,Calabria
2021-03-18 00:00:00,SAR,5758,2392,3366,1023,1291,327,3049,6,62,4214,1544,ITG,ITG2,20,Sardegna
2021-02-18 00:00:00,FVG,3210,1488,1722,229,138,331,1500,34,978,2804,406,ITH,ITH4,6,Friuli-Venezia Giulia
2021-03-11 00:00:00,UMB,3537,1680,1857,143,784,238,2013,201,158,2531,1006,ITI,ITI2,10,Umbria
2021-02-19 00:00:00,FVG,3250,1289,1961,566,323,312,1588,35,426,2821,429,ITH,ITH4,6,Friuli-Venezia Giulia
2021-01-17 00:00:00,BAS,328,133,195,233,41,54,0,0,0,327,1,ITF,ITF5,17,Basilicata
2021-02-06 00:00:00,UMB,396,138,258,333,47,16,0,0,0,34,362,ITI,ITI2,10,Umbria
2021-02-05 00:00:00,SAR,1897,749,1148,1214,515,164,1,3,0,433,1464,ITG,ITG2,20,Sardegna
2021-01-18 00:00:00,LIG,2125,740,1385,1247,430,438,0,0,10,1968,157,ITC,ITC3,7,Liguria
2021-01-10 00:00:00,SIC,3618,1615,2003,2126,1028,464,0,0,0,3618,0,ITG,ITG1,19,Sicilia
2021-01-16 00:00:00,LIG,1278,557,721,753,225,299,0,0,1,1278,0,ITC,ITC3,7,Liguria
2021-02-07 00:00:00,VDA,292,120,172,110,72,0,105,2,3,190,102,ITC,ITC2,2,Valle d'Aosta / Vall√©e d'Aoste
2021-02-22 00:00:00,LIG,3306,1450,1856,701,210,226,2167,0,2,3168,138,ITC,ITC3,7,Liguria
2021-02-23 00:00:00,VEN,7304,3214,4090,1007,493,213,5343,69,179,7046,258,ITH,ITH3,5,Veneto
2021-02-23 00:00:00,PAT,1096,393,703,272,15,17,741,3,48,885,211,ITH,ITH2,4,Provincia Autonoma Trento
2021-01-09 00:00:00,LAZ,6288,2556,3732,5110,558,620,0,0,0,6288,0,ITI,ITI4,12,Lazio
2021-01-20 00:00:00,BAS,84,22,62,0,84,0,0,0,0,84,0,ITF,ITF5,17,Basilicata
2021-02-28 00:00:00,FVG,2668,988,1680,234,163,0,405,378,1488,2273,395,ITH,ITH4,6,Friuli-Venezia Giulia
2021-03-11 00:00:00,VDA,192,72,120,2,14,7,166,1,2,64,128,ITC,ITC2,2,Valle d'Aosta / Vall√©e d'Aoste
2020-12-30 00:00:00,MAR,17,5,12,14,3,0,0,0,0,17,0,ITI,ITI3,11,Marche
2021-03-06 00:00:00,PAT,732,256,476,324,17,0,194,5,192,580,152,ITH,ITH2,4,Provincia Autonoma Trento
2021-01-30 00:00:00,VEN,8730,2668,6062,6209,1285,1218,4,12,2,687,8043,ITH,ITH3,5,Veneto
2020-12-31 00:00:00,PAT,1598,440,1158,819,109,670,0,0,0,1598,0,ITH,ITH2,4,Provincia Autonoma Trento
2021-02-14 00:00:00,CAM,3933,1926,2007,550,905,17,2461,0,0,3890,43,ITF,ITF3,15,Campania
2021-02-23 00:00:00,TOS,7719,3323,4396,1490,1571,204,509,1114,2831,7558,161,ITI,ITI1,9,Toscana
2021-03-02 00:00:00,VDA,339,166,173,17,106,39,107,65,5,336,3,ITC,ITC2,2,Valle d'Aosta / Vall√©e d'Aoste
2021-01-11 00:00:00,VDA,325,112,213,238,57,30,0,0,0,325,0,ITC,ITC2,2,Valle d'Aosta / Vall√©e d'Aoste
2021-01-17 00:00:00,MAR,1598,682,916,964,588,46,0,0,0,1549,49,ITI,ITI3,11,Marche
2021-01-18 00:00:00,PAT,640,154,486,527,40,73,0,0,0,586,54,ITH,ITH2,4,Provincia Autonoma Trento
2021-01-14 00:00:00,UMB,749,200,549,696,35,17,0,0,1,749,0,ITI,ITI2,10,Umbria
2021-01-20 00:00:00,ABR,447,156,291,147,96,204,0,0,0,445,2,ITF,ITF1,13,Abruzzo
2021-01-13 00:00:00,PAB,1317,409,908,368,588,255,106,0,0,1317,0,ITH,ITH1,4,Provincia Autonoma Bolzano / Bozen
2021-01-31 00:00:00,LIG,624,270,354,418,71,135,0,0,0,9,615,ITC,ITC3,7,Liguria
2021-03-05 00:00:00,UMB,4583,1378,3205,604,389,7,682,347,2554,3927,656,ITI,ITI2,10,Umbria
2021-03-08 00:00:00,SAR,3965,1777,2188,732,1160,624,852,444,153,2776,1189,ITG,ITG2,20,Sardegna
2021-03-06 00:00:00,PUG,15291,5706,9585,2111,773,70,5031,479,6827,13326,1965,ITF,ITF4,16,Puglia
2021-02-13 00:00:00,CAL,1331,583,748,731,488,111,1,0,0,968,363,ITF,ITF6,18,Calabria
2021-02-18 00:00:00,CAL,1799,802,997,585,509,299,345,0,61,1576,223,ITF,ITF6,18,Calabria
2020-12-28 00:00:00,LAZ,959,412,547,957,2,0,0,0,0,959,0,ITI,ITI4,12,Lazio
2021-02-12 00:00:00,SAR,2237,933,1304,986,749,501,1,0,0,2178,59,ITG,ITG2,20,Sardegna
2021-01-15 00:00:00,SAR,1563,573,990,1170,390,0,0,3,0,1563,0,ITG,ITG2,20,Sardegna
2021-01-18 00:00:00,SIC,1548,646,902,721,619,208,0,0,0,1432,116,ITG,ITG1,19,Sicilia
2021-01-08 00:00:00,PUG,5573,2337,3236,4844,401,325,0,0,3,5573,0,ITF,ITF4,16,Puglia
2021-03-17 00:00:00,MOL,894,381,513,34,805,42,0,12,1,563,331,ITF,ITF2,14,Molise
2021-01-25 00:00:00,CAL,1064,512,552,1021,43,0,0,0,0,156,908,ITF,ITF6,18,Calabria
2021-03-07 00:00:00,TOS,5647,2356,3291,3102,1097,123,15,536,774,2106,3541,ITI,ITI1,9,Toscana
2021-02-19 00:00:00,CAL,1461,652,809,544,341,195,380,1,0,1200,261,ITF,ITF6,18,Calabria
2021-03-01 00:00:00,PUG,14791,5762,9029,1946,913,84,6005,818,5025,13429,1362,ITF,ITF4,16,Puglia
2021-02-21 00:00:00,SIC,5173,2504,2669,376,650,174,3682,138,153,5068,105,ITG,ITG1,19,Sicilia
2021-02-10 00:00:00,LIG,2275,827,1448,1350,419,496,5,0,5,1014,1261,ITC,ITC3,7,Liguria
2021-02-25 00:00:00,LOM,14857,6181,8676,2810,1548,1287,7986,1216,10,13450,1407,ITC,ITC4,3,Lombardia
2021-02-05 00:00:00,EMR,9293,2959,6334,6211,1287,1607,187,0,1,1625,7668,ITH,ITH5,8,Emilia-Romagna
2021-02-01 00:00:00,ABR,1632,573,1059,1384,247,1,0,0,0,271,1361,ITF,ITF1,13,Abruzzo
2021-02-15 00:00:00,PAT,531,186,345,145,28,27,320,0,11,417,114,ITH,ITH2,4,Provincia Autonoma Trento
2021-01-19 00:00:00,LOM,8003,2322,5681,4013,1807,2117,65,1,0,7527,476,ITC,ITC4,3,Lombardia
2021-02-09 00:00:00,PUG,3834,1567,2267,2533,667,621,8,0,5,2162,1672,ITF,ITF4,16,Puglia
2021-03-02 00:00:00,MAR,4963,1943,3020,589,275,242,3316,3,538,4397,566,ITI,ITI3,11,Marche
2021-02-14 00:00:00,LOM,3558,1539,2019,2749,772,24,3,0,10,2937,621,ITC,ITC4,3,Lombardia
2021-01-05 00:00:00,LAZ,7370,2802,4568,6690,102,577,0,1,0,7370,0,ITI,ITI4,12,Lazio
2021-02-27 00:00:00,LOM,13808,5815,7993,2001,1867,558,8243,1091,48,13264,544,ITC,ITC4,3,Lombardia
2021-02-02 00:00:00,UMB,942,274,668,713,17,212,0,0,0,32,910,ITI,ITI2,10,Umbria
2020-12-27 00:00:00,BAS,106,41,65,104,2,0,0,0,0,106,0,ITF,ITF5,17,Basilicata
2021-03-10 00:00:00,CAL,6441,3278,3163,742,2351,586,2021,677,64,5250,1191,ITF,ITF6,18,Calabria
2021-03-18 00:00:00,LOM,24112,9588,14524,1983,1814,1226,18953,44,92,14783,9329,ITC,ITC4,3,Lombardia
2021-01-13 00:00:00,TOS,4063,1398,2665,3308,350,405,0,0,0,4063,0,ITI,ITI1,9,Toscana
2021-03-15 00:00:00,UMB,4592,1927,2665,1426,347,78,2337,141,263,2822,1770,ITI,ITI2,10,Umbria
2021-01-11 00:00:00,CAL,2154,1040,1114,1759,392,3,0,0,0,2154,0,ITF,ITF6,18,Calabria
2021-01-30 00:00:00,PUG,5523,2510,3013,4747,348,419,3,0,6,413,5110,ITF,ITF4,16,Puglia
2021-02-21 00:00:00,LOM,5004,1851,3153,1743,959,32,2227,40,3,4984,20,ITC,ITC4,3,Lombardia
2020-12-30 00:00:00,LOM,113,42,71,105,8,0,0,0,0,113,0,ITC,ITC4,3,Lombardia
2021-01-19 00:00:00,TOS,1104,531,573,392,221,491,0,0,0,1104,0,ITI,ITI1,9,Toscana
2021-02-13 00:00:00,LAZ,6272,2435,3837,2123,213,280,3656,0,0,6184,88,ITI,ITI4,12,Lazio
2021-03-18 00:00:00,TOS,8584,3436,5148,422,1402,138,6614,6,2,5140,3444,ITI,ITI1,9,Toscana
2021-02-20 00:00:00,PIE,3828,1251,2577,1100,1063,219,30,0,1416,3654,174,ITC,ITC1,1,Piemonte
2021-01-01 00:00:00,CAM,919,506,413,831,88,0,0,0,0,919,0,ITF,ITF3,15,Campania
2021-01-14 00:00:00,FVG,2588,789,1799,1608,550,430,0,0,0,2588,0,ITH,ITH4,6,Friuli-Venezia Giulia
2021-02-20 00:00:00,UMB,282,100,182,83,8,39,152,0,0,258,24,ITI,ITI2,10,Umbria
2021-01-31 00:00:00,SIC,4111,1958,2153,2600,1216,295,0,0,0,113,3998,ITG,ITG1,19,Sicilia
2021-02-13 00:00:00,TOS,7784,2360,5424,3666,3768,163,0,186,1,7557,227,ITI,ITI1,9,Toscana
2021-02-11 00:00:00,CAM,6279,2705,3574,1861,1926,129,2363,0,0,6213,66,ITF,ITF3,15,Campania
2021-02-01 00:00:00,PAB,1385,404,981,709,379,296,0,0,1,11,1374,ITH,ITH1,4,Provincia Autonoma Bolzano / Bozen
2021-03-18 00:00:00,LAZ,13607,5858,7749,1596,2647,266,9083,9,6,7457,6150,ITI,ITI4,12,Lazio
2021-02-19 00:00:00,LIG,3089,1278,1811,984,593,97,1412,0,3,2913,176,ITC,ITC3,7,Liguria
2021-02-09 00:00:00,ABR,908,311,597,612,165,131,0,0,0,499,409,ITF,ITF1,13,Abruzzo
2021-01-21 00:00:00,PAT,349,93,256,318,15,16,0,0,0,227,122,ITH,ITH2,4,Provincia Autonoma Trento
2021-02-27 00:00:00,FVG,3415,1175,2240,202,171,0,1520,25,1497,3415,0,ITH,ITH4,6,Friuli-Venezia Giulia
2021-03-08 00:00:00,BAS,1450,707,743,221,252,38,410,256,273,840,610,ITF,ITF5,17,Basilicata
2021-03-04 00:00:00,PAT,2326,781,1545,160,81,23,1698,19,345,1478,848,ITH,ITH2,4,Provincia Autonoma Trento
2021-02-01 00:00:00,TOS,5465,1942,3523,4441,407,617,0,0,0,521,4944,ITI,ITI1,9,Toscana
2021-02-16 00:00:00,MAR,1292,475,817,737,463,92,0,0,0,1262,30,ITI,ITI3,11,Marche
2021-02-04 00:00:00,ABR,1681,616,1065,1168,456,57,0,0,0,609,1072,ITF,ITF1,13,Abruzzo
2021-02-25 00:00:00,LAZ,12574,5493,7081,1754,1209,488,5089,1423,2611,11528,1046,ITI,ITI4,12,Lazio
2021-03-09 00:00:00,SAR,5140,2368,2772,1055,892,285,2266,332,310,4410,730,ITG,ITG2,20,Sardegna
2021-02-10 00:00:00,SIC,4433,1819,2614,1975,1717,741,0,0,0,4008,425,ITG,ITG1,19,Sicilia
2021-02-09 00:00:00,LOM,12006,3283,8723,5681,2285,3959,75,2,4,3980,8026,ITC,ITC4,3,Lombardia
2021-03-15 00:00:00,PUG,11339,5441,5898,2053,804,115,7505,348,514,4937,6402,ITF,ITF4,16,Puglia
2021-02-25 00:00:00,TOS,10580,4281,6299,1078,1702,259,3201,1141,3199,9586,994,ITI,ITI1,9,Toscana
2021-02-24 00:00:00,VDA,183,82,101,30,15,13,65,53,7,164,19,ITC,ITC2,2,Valle d'Aosta / Vall√©e d'Aoste
2021-02-07 00:00:00,EMR,4786,1534,3252,3685,644,444,10,0,3,1727,3059,ITH,ITH5,8,Emilia-Romagna
2021-01-23 00:00:00,MAR,557,190,367,440,54,63,0,0,0,123,434,ITI,ITI3,11,Marche
2021-01-26 00:00:00,LAZ,7602,2907,4695,6590,256,631,125,0,0,372,7230,ITI,ITI4,12,Lazio
2021-01-02 00:00:00,FVG,1217,471,746,1150,67,0,0,0,0,1217,0,ITH,ITH4,6,Friuli-Venezia Giulia
2021-01-24 00:00:00,PAT,545,274,271,533,12,0,0,0,0,223,322,ITH,ITH2,4,Provincia Autonoma Trento
2021-02-18 00:00:00,LIG,2756,1126,1630,953,422,349,1030,0,2,2428,328,ITC,ITC3,7,Liguria
2021-01-14 00:00:00,PUG,4056,1582,2474,3161,394,499,0,0,2,4056,0,ITF,ITF4,16,Puglia
2021-03-15 00:00:00,SAR,2678,1214,1464,457,648,85,323,149,1016,2305,373,ITG,ITG2,20,Sardegna
2021-03-12 00:00:00,MOL,1156,489,667,38,653,0,0,68,397,1120,36,ITF,ITF2,14,Molise
2021-01-29 00:00:00,VDA,316,138,178,259,41,16,0,0,0,2,314,ITC,ITC2,2,Valle d'Aosta / Vall√©e d'Aoste
2021-01-23 00:00:00,ABR,263,114,149,223,14,26,0,0,0,57,206,ITF,ITF1,13,Abruzzo
2021-01-02 00:00:00,SAR,60,21,39,60,0,0,0,0,0,60,0,ITG,ITG2,20,Sardegna
2021-02-02 00:00:00,MOL,486,155,331,295,63,128,0,0,0,163,323,ITF,ITF2,14,Molise
2021-02-10 00:00:00,BAS,547,237,310,176,153,127,90,0,1,495,52,ITF,ITF5,17,Basilicata
2021-01-31 00:00:00,BAS,77,24,53,75,2,0,0,0,0,0,77,ITF,ITF5,17,Basilicata
2021-02-20 00:00:00,PAT,405,245,160,330,10,30,1,3,31,121,284,ITH,ITH2,4,Provincia Autonoma Trento
2021-02-07 00:00:00,SIC,2348,996,1352,1610,581,157,0,0,0,675,1673,ITG,ITG1,19,Sicilia
2021-03-16 00:00:00,PIE,10240,4138,6102,2228,1075,320,6604,0,13,4189,6051,ITC,ITC1,1,Piemonte
2021-01-13 00:00:00,LIG,2753,1012,1741,1912,350,487,0,0,4,2753,0,ITC,ITC3,7,Liguria
2021-02-25 00:00:00,VEN,7847,3319,4528,1491,564,467,4942,109,274,7254,593,ITH,ITH3,5,Veneto
2021-03-12 00:00:00,PUG,13661,6004,7657,3277,1311,430,4881,877,2885,9738,3923,ITF,ITF4,16,Puglia
2021-02-07 00:00:00,PAB,2165,975,1190,99,398,1,1667,0,0,12,2153,ITH,ITH1,4,Provincia Autonoma Bolzano / Bozen
2021-01-19 00:00:00,VDA,256,77,179,160,24,15,57,0,0,256,0,ITC,ITC2,2,Valle d'Aosta / Vall√©e d'Aoste
2021-01-08 00:00:00,MAR,1574,588,986,1226,348,0,0,0,0,1574,0,ITI,ITI3,11,Marche
2021-02-24 00:00:00,FVG,2517,1082,1435,23,53,310,1834,0,297,2499,18,ITH,ITH4,6,Friuli-Venezia Giulia
2021-01-29 00:00:00,LAZ,7593,2865,4728,6372,427,704,90,0,0,477,7116,ITI,ITI4,12,Lazio
2021-02-25 00:00:00,LIG,3438,1346,2092,550,214,88,2583,2,1,3309,129,ITC,ITC3,7,Liguria
2021-03-04 00:00:00,CAM,14645,5345,9300,1788,5088,135,4198,1,3435,8752,5893,ITF,ITF3,15,Campania
2020-12-27 00:00:00,EMR,968,372,596,824,118,26,0,0,0,968,0,ITH,ITH5,8,Emilia-Romagna
2021-02-08 00:00:00,PIE,6914,2355,4559,3782,1558,1574,0,0,0,666,6248,ITC,ITC1,1,Piemonte
2021-03-05 00:00:00,TOS,16202,6212,9990,3920,2394,170,5098,748,3872,11462,4740,ITI,ITI1,9,Toscana
2021-02-10 00:00:00,LOM,14104,4429,9675,8405,2353,3266,71,3,6,7413,6691,ITC,ITC4,3,Lombardia
2021-02-05 00:00:00,PAT,802,271,531,467,22,66,247,0,0,283,519,ITH,ITH2,4,Provincia Autonoma Trento
2021-03-12 00:00:00,SAR,5608,2350,3258,1035,1255,451,2437,271,159,4301,1307,ITG,ITG2,20,Sardegna
2021-02-26 00:00:00,SIC,12240,5975,6265,1836,1970,360,3888,1733,2453,10554,1686,ITG,ITG1,19,Sicilia
2021-03-18 00:00:00,BAS,1232,514,718,30,9,0,1193,0,0,22,1210,ITF,ITF5,17,Basilicata
2021-01-14 00:00:00,ABR,530,189,341,364,166,0,0,0,0,530,0,ITF,ITF1,13,Abruzzo
2021-03-16 00:00:00,UMB,3502,1433,2069,1633,88,65,1706,0,10,1875,1627,ITI,ITI2,10,Umbria
2021-01-26 00:00:00,MAR,2016,746,1270,1736,194,86,0,0,0,92,1924,ITI,ITI3,11,Marche
2021-01-19 00:00:00,SAR,747,270,477,423,163,160,0,0,1,692,55,ITG,ITG2,20,Sardegna
2021-01-16 00:00:00,VEN,4598,1539,3059,3193,756,649,0,0,0,4598,0,ITH,ITH3,5,Veneto
2021-03-11 00:00:00,MOL,695,315,380,18,258,12,0,147,260,689,6,ITF,ITF2,14,Molise
2021-01-28 00:00:00,VDA,290,123,167,197,85,6,2,0,0,56,234,ITC,ITC2,2,Valle d'Aosta / Vall√©e d'Aoste
2020-12-31 00:00:00,MAR,383,178,205,370,13,0,0,0,0,383,0,ITI,ITI3,11,Marche
2021-03-04 00:00:00,MAR,6608,2961,3647,1064,938,106,2798,934,768,5214,1394,ITI,ITI3,11,Marche
2021-01-17 00:00:00,SIC,1295,584,711,619,516,160,0,0,0,1245,50,ITG,ITG1,19,Sicilia
2021-01-25 00:00:00,MOL,319,130,189,317,0,0,0,0,2,3,316,ITF,ITF2,14,Molise
2021-03-17 00:00:00,CAL,3634,1621,2013,277,980,165,2093,26,93,1937,1697,ITF,ITF6,18,Calabria
2021-02-14 00:00:00,MAR,738,301,437,578,160,0,0,0,0,738,0,ITI,ITI3,11,Marche
2021-02-23 00:00:00,LOM,11669,4761,6908,3935,1614,831,4296,990,3,11361,308,ITC,ITC4,3,Lombardia
2021-01-18 00:00:00,CAL,1230,550,680,982,237,11,0,0,0,1040,190,ITF,ITF6,18,Calabria
2021-02-11 00:00:00,FVG,1930,663,1267,1134,568,224,3,1,0,1737,193,ITH,ITH4,6,Friuli-Venezia Giulia
2021-02-11 00:00:00,LAZ,6657,2788,3869,2196,334,500,3627,0,0,6459,198,ITI,ITI4,12,Lazio
2021-02-28 00:00:00,LAZ,10199,3991,6208,1601,688,77,4552,682,2599,9685,514,ITI,ITI4,12,Lazio
2021-02-22 00:00:00,PIE,8460,3462,4998,1695,1439,518,3888,0,920,7871,589,ITC,ITC1,1,Piemonte
2021-01-13 00:00:00,LOM,25728,7911,17817,15529,5945,4062,189,2,1,25728,0,ITC,ITC4,3,Lombardia
2020-12-29 00:00:00,SIC,235,146,89,235,0,0,0,0,0,235,0,ITG,ITG1,19,Sicilia
2021-02-21 00:00:00,BAS,284,113,171,16,2,11,254,0,1,284,0,ITF,ITF5,17,Basilicata
2021-03-06 00:00:00,CAL,7945,4053,3892,701,1872,758,3795,813,6,7190,755,ITF,ITF6,18,Calabria
2021-01-28 00:00:00,CAL,2232,1107,1125,1920,312,0,0,0,0,84,2148,ITF,ITF6,18,Calabria
2021-02-05 00:00:00,PUG,5622,2269,3353,4562,525,526,0,3,6,1325,4297,ITF,ITF4,16,Puglia
2021-01-29 00:00:00,UMB,1221,343,878,934,16,271,0,0,0,79,1142,ITI,ITI2,10,Umbria
2021-01-05 00:00:00,PAB,821,283,538,728,93,0,0,0,0,821,0,ITH,ITH1,4,Provincia Autonoma Bolzano / Bozen
2020-12-30 00:00:00,SIC,173,101,72,156,17,0,0,0,0,173,0,ITG,ITG1,19,Sicilia
2021-01-06 00:00:00,TOS,4519,1459,3060,3984,10,525,0,0,0,4519,0,ITI,ITI1,9,Toscana
2021-02-07 00:00:00,UMB,54,17,37,46,8,0,0,0,0,1,53,ITI,ITI2,10,Umbria
2021-02-12 00:00:00,MOL,330,149,181,224,32,72,0,0,2,208,122,ITF,ITF2,14,Molise
2021-02-13 00:00:00,VDA,215,195,20,0,54,0,0,161,0,215,0,ITC,ITC2,2,Valle d'Aosta / Vall√©e d'Aoste
2020-12-27 00:00:00,LIG,135,56,79,88,2,45,0,0,0,135,0,ITC,ITC3,7,Liguria
2021-02-25 00:00:00,BAS,1786,735,1051,67,14,0,1704,1,0,1740,46,ITF,ITF5,17,Basilicata
2021-02-28 00:00:00,BAS,799,341,458,32,30,0,737,0,0,771,28,ITF,ITF5,17,Basilicata
2021-01-20 00:00:00,MOL,18,8,10,14,4,0,0,0,0,18,0,ITF,ITF2,14,Molise
2020-12-28 00:00:00,LIG,80,30,50,77,3,0,0,0,0,80,0,ITC,ITC3,7,Liguria
2021-02-09 00:00:00,SAR,2286,837,1449,1308,479,497,1,0,1,1290,996,ITG,ITG2,20,Sardegna
2021-01-11 00:00:00,LAZ,5525,2103,3422,4553,403,569,0,0,0,5525,0,ITI,ITI4,12,Lazio
2021-01-21 00:00:00,PUG,2129,903,1226,1429,174,526,0,0,0,1270,859,ITF,ITF4,16,Puglia
2021-01-06 00:00:00,EMR,8262,2941,5321,6850,761,650,0,1,0,8262,0,ITH,ITH5,8,Emilia-Romagna
2021-02-15 00:00:00,TOS,8770,3374,5396,4536,2028,216,56,794,1140,7945,825,ITI,ITI1,9,Toscana
2021-03-05 00:00:00,CAL,6145,3540,2605,695,1589,710,1854,1292,5,5570,575,ITF,ITF6,18,Calabria
2021-01-31 00:00:00,EMR,7692,2758,4934,6172,1259,261,0,0,0,242,7450,ITH,ITH5,8,Emilia-Romagna
2021-03-14 00:00:00,EMR,8454,3616,4838,697,940,69,5494,359,895,4678,3776,ITH,ITH5,8,Emilia-Romagna
2021-01-22 00:00:00,PUG,1409,579,830,876,157,373,2,0,1,992,417,ITF,ITF4,16,Puglia
2021-01-28 00:00:00,LIG,2840,968,1872,2237,288,309,0,1,5,40,2800,ITC,ITC3,7,Liguria
2021-03-04 00:00:00,TOS,17296,6580,10716,2816,1649,240,8082,814,3695,14220,3076,ITI,ITI1,9,Toscana
2021-02-16 00:00:00,CAM,5437,2410,3027,911,1183,169,3174,0,0,4666,771,ITF,ITF3,15,Campania
2021-03-11 00:00:00,SIC,14747,6224,8523,1604,4707,906,3931,473,3126,12175,2572,ITG,ITG1,19,Sicilia
2021-02-16 00:00:00,PIE,3961,1752,2209,1819,1593,548,0,0,1,3203,758,ITC,ITC1,1,Piemonte
2021-02-02 00:00:00,SIC,5537,2621,2916,3152,1956,429,0,0,0,633,4904,ITG,ITG1,19,Sicilia
2021-02-10 00:00:00,PUG,3603,1425,2178,2491,247,864,0,0,1,2122,1481,ITF,ITF4,16,Puglia
2021-01-25 00:00:00,CAM,5744,2926,2818,4743,945,56,0,0,0,164,5580,ITF,ITF3,15,Campania
2021-03-17 00:00:00,LOM,24464,9710,14754,2456,2236,1689,18000,44,39,14231,10233,ITC,ITC4,3,Lombardia
2021-03-08 00:00:00,PUG,14263,5916,8347,2092,1135,202,6585,520,3729,11887,2376,ITF,ITF4,16,Puglia
2021-02-17 00:00:00,LOM,11757,3705,8052,7564,2249,1857,39,38,10,10402,1355,ITC,ITC4,3,Lombardia
2021-02-25 00:00:00,EMR,9149,3471,5678,793,514,140,7617,0,85,8198,951,ITH,ITH5,8,Emilia-Romagna
2021-02-28 00:00:00,VEN,4127,1382,2745,1702,1424,15,983,0,3,3290,837,ITH,ITH3,5,Veneto
2021-02-14 00:00:00,PIE,1475,498,977,796,380,285,0,0,14,875,600,ITC,ITC1,1,Piemonte
2021-02-27 00:00:00,CAM,13941,4470,9471,597,3062,78,3146,0,7058,12299,1642,ITF,ITF3,15,Campania
2021-03-07 00:00:00,LAZ,13993,5398,8595,1200,1229,148,7187,696,3533,10404,3589,ITI,ITI4,12,Lazio
2021-01-26 00:00:00,VEN,6902,2081,4821,5338,595,963,0,1,5,155,6747,ITH,ITH3,5,Veneto
2021-02-18 00:00:00,CAM,9078,3811,5267,1710,1342,70,5520,0,436,8370,708,ITF,ITF3,15,Campania
2021-02-28 00:00:00,CAL,2167,983,1184,113,152,190,1706,6,0,2016,151,ITF,ITF6,18,Calabria
2021-02-04 00:00:00,VEN,7309,2012,5297,3454,1459,2380,12,0,4,556,6753,ITH,ITH3,5,Veneto
2021-01-09 00:00:00,PUG,4867,2245,2622,4313,303,246,4,0,1,4867,0,ITF,ITF4,16,Puglia
2021-03-10 00:00:00,VEN,18716,8484,10232,1407,2495,555,9051,1074,4134,13044,5672,ITH,ITH3,5,Veneto
2020-12-27 00:00:00,LOM,702,407,295,601,86,14,1,0,0,702,0,ITC,ITC4,3,Lombardia
2021-02-05 00:00:00,MAR,2156,653,1503,1317,420,419,0,0,0,440,1716,ITI,ITI3,11,Marche
2021-03-08 00:00:00,FVG,3873,1528,2345,684,538,7,2169,39,436,1816,2057,ITH,ITH4,6,Friuli-Venezia Giulia
2021-02-17 00:00:00,CAM,7388,3210,4178,995,1085,38,4908,0,362,6328,1060,ITF,ITF3,15,Campania
2021-03-01 00:00:00,ABR,3485,1390,2095,697,293,174,1911,128,282,2722,763,ITF,ITF1,13,Abruzzo
2021-02-21 00:00:00,SAR,1584,709,875,66,32,59,1421,6,0,1554,30,ITG,ITG2,20,Sardegna
2021-03-17 00:00:00,EMR,13388,5556,7832,348,1329,50,11642,0,19,5676,7712,ITH,ITH5,8,Emilia-Romagna
2021-01-13 00:00:00,LAZ,5559,2063,3496,4145,402,1009,3,0,0,5559,0,ITI,ITI4,12,Lazio
2021-01-09 00:00:00,PIE,6183,2185,3998,4488,1127,568,0,0,0,6183,0,ITC,ITC1,1,Piemonte
2021-02-24 00:00:00,PIE,11382,4617,6765,1843,1314,407,5660,0,2158,10871,511,ITC,ITC1,1,Piemonte
2021-02-02 00:00:00,EMR,9430,3030,6400,6230,1490,1629,80,0,1,496,8934,ITH,ITH5,8,Emilia-Romagna
2021-01-09 00:00:00,CAM,10566,5024,5542,6759,3538,269,0,0,0,10566,0,ITF,ITF3,15,Campania
2021-01-17 00:00:00,TOS,2535,871,1664,2002,293,240,0,0,0,2022,513,ITI,ITI1,9,Toscana
2021-02-12 00:00:00,FVG,1200,428,772,674,395,128,2,0,1,1150,50,ITH,ITH4,6,Friuli-Venezia Giulia
2021-03-10 00:00:00,PAT,2333,903,1430,347,79,25,1374,221,287,1393,940,ITH,ITH2,4,Provincia Autonoma Trento
2021-03-08 00:00:00,ABR,5127,1669,3458,1190,507,112,1019,104,2195,4153,974,ITF,ITF1,13,Abruzzo
2021-01-31 00:00:00,SAR,2121,750,1371,1544,576,0,1,0,0,48,2073,ITG,ITG2,20,Sardegna
2020-12-27 00:00:00,ABR,37,19,18,34,1,2,0,0,0,37,0,ITF,ITF1,13,Abruzzo
2021-01-21 00:00:00,CAL,958,444,514,735,108,115,0,0,0,929,29,ITF,ITF6,18,Calabria
2021-02-15 00:00:00,PUG,3242,1263,1979,2245,536,452,0,6,3,2623,619,ITF,ITF4,16,Puglia
2021-01-09 00:00:00,PAT,184,40,144,139,14,31,0,0,0,184,0,ITH,ITH2,4,Provincia Autonoma Trento
2021-02-18 00:00:00,PIE,4780,2088,2692,2250,1904,624,0,0,2,4350,430,ITC,ITC1,1,Piemonte
2021-02-02 00:00:00,MAR,1193,397,796,804,296,93,0,0,0,73,1120,ITI,ITI3,11,Marche
2021-01-11 00:00:00,TOS,5092,1689,3403,4360,210,522,0,0,0,5092,0,ITI,ITI1,9,Toscana
2021-02-25 00:00:00,SIC,10151,5273,4878,1770,1700,507,3979,1525,670,8974,1177,ITG,ITG1,19,Sicilia
2021-02-15 00:00:00,CAM,5469,2515,2954,976,1002,94,3395,1,1,5296,173,ITF,ITF3,15,Campania
2021-01-23 00:00:00,PAB,195,115,80,183,12,0,0,0,0,0,195,ITH,ITH1,4,Provincia Autonoma Bolzano / Bozen
2021-01-06 00:00:00,ABR,1830,664,1166,1546,151,133,0,0,0,1830,0,ITF,ITF1,13,Abruzzo
2021-01-31 00:00:00,FVG,2713,836,1877,1692,1003,18,0,0,0,385,2328,ITH,ITH4,6,Friuli-Venezia Giulia
2020-12-27 00:00:00,VDA,20,9,11,20,0,0,0,0,0,20,0,ITC,ITC2,2,Valle d'Aosta / Vall√©e d'Aoste
2021-02-08 00:00:00,MAR,833,258,575,408,163,262,0,0,0,371,462,ITI,ITI3,11,Marche
2021-01-04 00:00:00,LAZ,7478,2907,4571,7075,86,316,0,0,1,7478,0,ITI,ITI4,12,Lazio
2021-03-08 00:00:00,EMR,11425,4502,6923,2297,1031,295,4272,1212,2318,8802,2623,ITH,ITH5,8,Emilia-Romagna
2021-02-09 00:00:00,CAM,4642,2201,2441,1148,2150,6,1338,0,0,4390,252,ITF,ITF3,15,Campania
2021-02-27 00:00:00,PAB,2454,758,1696,202,128,8,881,3,1232,2445,9,ITH,ITH1,4,Provincia Autonoma Bolzano / Bozen
2021-01-28 00:00:00,SAR,2968,1044,1924,2554,403,0,0,11,0,69,2899,ITG,ITG2,20,Sardegna
2021-02-07 00:00:00,CAM,2936,1386,1550,712,1708,226,290,0,0,2158,778,ITF,ITF3,15,Campania
2021-03-17 00:00:00,FVG,2955,1178,1777,407,283,75,2185,3,2,554,2401,ITH,ITH4,6,Friuli-Venezia Giulia
2021-01-15 00:00:00,EMR,7698,2392,5306,5296,1084,1317,0,0,1,7698,0,ITH,ITH5,8,Emilia-Romagna
2021-01-15 00:00:00,VDA,218,82,136,116,68,28,6,0,0,218,0,ITC,ITC2,2,Valle d'Aosta / Vall√©e d'Aoste
2021-02-01 00:00:00,LAZ,5669,2173,3496,4784,319,559,7,0,0,353,5316,ITI,ITI4,12,Lazio
2021-03-17 00:00:00,LIG,5405,2332,3073,751,363,40,4243,2,6,2420,2985,ITC,ITC3,7,Liguria
2021-02-10 00:00:00,FVG,1352,496,856,745,487,119,0,0,1,1266,86,ITH,ITH4,6,Friuli-Venezia Giulia
2021-01-25 00:00:00,PAB,462,177,285,380,80,0,1,0,1,3,459,ITH,ITH1,4,Provincia Autonoma Bolzano / Bozen
2021-01-07 00:00:00,LAZ,7724,2894,4830,6881,277,566,0,0,0,7724,0,ITI,ITI4,12,Lazio
2021-01-17 00:00:00,PAB,2270,1025,1245,54,236,19,1961,0,0,2259,11,ITH,ITH1,4,Provincia Autonoma Bolzano / Bozen
2021-02-01 00:00:00,BAS,242,91,151,156,38,48,0,0,0,46,196,ITF,ITF5,17,Basilicata
2021-01-05 00:00:00,MAR,1562,586,976,1436,126,0,0,0,0,1562,0,ITI,ITI3,11,Marche
2021-01-10 00:00:00,SAR,2183,750,1433,1632,551,0,0,0,0,2183,0,ITG,ITG2,20,Sardegna
2021-01-26 00:00:00,FVG,1972,647,1325,1439,152,381,0,0,0,214,1758,ITH,ITH4,6,Friuli-Venezia Giulia
2021-01-28 00:00:00,VEN,9203,2661,6542,6458,1289,1448,5,0,3,175,9028,ITH,ITH3,5,Veneto
2021-01-27 00:00:00,MAR,2120,780,1340,1754,226,140,0,0,0,122,1998,ITI,ITI3,11,Marche
2021-02-09 00:00:00,LIG,1893,680,1213,1080,336,455,0,0,22,256,1637,ITC,ITC3,7,Liguria
2021-03-10 00:00:00,FVG,3321,1491,1830,297,364,185,1971,309,195,1532,1789,ITH,ITH4,6,Friuli-Venezia Giulia
2021-03-03 00:00:00,SIC,14650,6517,8133,2407,2323,507,4282,1325,3806,11569,3081,ITG,ITG1,19,Sicilia
2021-03-17 00:00:00,SAR,5733,2455,3278,1066,1363,527,2646,3,128,4132,1601,ITG,ITG2,20,Sardegna
2021-02-04 00:00:00,UMB,732,226,506,692,20,20,0,0,0,25,707,ITI,ITI2,10,Umbria
2020-12-31 00:00:00,CAM,1490,811,679,1273,216,1,0,0,0,1490,0,ITF,ITF3,15,Campania
2021-02-21 00:00:00,CAL,607,286,321,36,164,47,330,30,0,530,77,ITF,ITF6,18,Calabria
2021-03-02 00:00:00,UMB,3626,1343,2283,318,276,55,1290,241,1446,3622,4,ITI,ITI2,10,Umbria
2021-02-04 00:00:00,PAB,1876,568,1308,623,620,419,214,0,0,8,1868,ITH,ITH1,4,Provincia Autonoma Bolzano / Bozen
2021-01-30 00:00:00,MOL,461,158,303,189,92,180,0,0,0,12,449,ITF,ITF2,14,Molise
2021-02-01 00:00:00,SIC,6077,2684,3393,4168,1591,318,0,0,0,304,5773,ITG,ITG1,19,Sicilia
2021-01-29 00:00:00,EMR,10326,3477,6849,8081,1228,1017,0,0,0,289,10037,ITH,ITH5,8,Emilia-Romagna
2021-01-04 00:00:00,SIC,8373,4172,4201,7595,772,6,0,0,0,8373,0,ITG,ITG1,19,Sicilia
2020-12-30 00:00:00,PIE,730,322,408,685,45,0,0,0,0,730,0,ITC,ITC1,1,Piemonte
2021-01-04 00:00:00,BAS,607,271,336,550,55,0,0,0,2,607,0,ITF,ITF5,17,Basilicata
2021-01-23 00:00:00,UMB,277,100,177,276,1,0,0,0,0,2,275,ITI,ITI2,10,Umbria
2021-03-11 00:00:00,LAZ,23517,10479,13038,4797,3133,440,9185,1526,4436,17301,6216,ITI,ITI4,12,Lazio
2021-02-15 00:00:00,LIG,2254,837,1417,1083,265,241,662,1,2,1861,393,ITC,ITC3,7,Liguria
2021-03-12 00:00:00,BAS,1894,974,920,265,108,37,985,241,258,796,1098,ITF,ITF5,17,Basilicata
2021-01-28 00:00:00,PAB,867,307,560,584,214,69,0,0,0,10,857,ITH,ITH1,4,Provincia Autonoma Bolzano / Bozen
2021-03-14 00:00:00,PUG,3121,1353,1768,952,203,73,972,42,879,2366,755,ITF,ITF4,16,Puglia
2021-02-15 00:00:00,BAS,621,232,389,191,137,46,246,1,0,580,41,ITF,ITF5,17,Basilicata
2021-02-22 00:00:00,LAZ,11382,4968,6414,1778,309,472,5211,1390,2222,10881,501,ITI,ITI4,12,Lazio
2021-03-04 00:00:00,ABR,5936,2358,3578,1170,535,93,2992,328,818,5015,921,ITF,ITF1,13,Abruzzo
2021-03-13 00:00:00,PUG,9885,3888,5997,2150,421,127,3764,220,3203,8162,1723,ITF,ITF4,16,Puglia
2021-03-03 00:00:00,CAL,4865,2651,2214,631,1157,917,1367,789,4,3802,1063,ITF,ITF6,18,Calabria
2021-02-09 00:00:00,PIE,7350,2309,5041,4153,1366,1831,0,0,0,722,6628,ITC,ITC1,1,Piemonte
2021-01-14 00:00:00,PAB,1809,540,1269,477,761,285,286,0,0,1809,0,ITH,ITH1,4,Provincia Autonoma Bolzano / Bozen
2021-01-19 00:00:00,PUG,1221,452,769,527,117,577,0,0,0,1211,10,ITF,ITF4,16,Puglia
2021-03-18 00:00:00,VDA,134,43,91,4,4,25,100,1,0,98,36,ITC,ITC2,2,Valle d'Aosta / Vall√©e d'Aoste
2021-02-07 00:00:00,VEN,2313,861,1452,1930,330,50,2,0,1,714,1599,ITH,ITH3,5,Veneto
2021-02-24 00:00:00,LAZ,11946,5172,6774,1796,936,337,5150,1327,2400,10957,989,ITI,ITI4,12,Lazio
2020-12-30 00:00:00,VEN,699,245,454,598,62,39,0,0,0,699,0,ITH,ITH3,5,Veneto
2021-02-26 00:00:00,PAT,1206,431,775,249,23,19,809,1,105,882,324,ITH,ITH2,4,Provincia Autonoma Trento
2021-02-28 00:00:00,SIC,7176,3071,4105,870,1311,93,3289,254,1359,6547,629,ITG,ITG1,19,Sicilia
2021-03-10 00:00:00,MAR,5703,2439,3264,721,808,101,2673,362,1038,4566,1137,ITI,ITI3,11,Marche
2021-03-17 00:00:00,PUG,9604,4428,5176,1730,577,51,7149,33,64,3970,5634,ITF,ITF4,16,Puglia
2021-03-16 00:00:00,LAZ,13312,5660,7652,1469,2199,279,9353,7,5,6951,6361,ITI,ITI4,12,Lazio
2021-02-11 00:00:00,SIC,5332,2103,3229,2458,1984,890,0,0,0,4868,464,ITG,ITG1,19,Sicilia
2020-12-30 00:00:00,LAZ,1630,629,1001,1603,0,27,0,0,0,1630,0,ITI,ITI4,12,Lazio
2021-03-15 00:00:00,TOS,8216,3278,4938,3216,1956,320,23,420,2281,3804,4412,ITI,ITI1,9,Toscana
2021-02-04 00:00:00,CAL,3391,1623,1768,2560,609,222,0,0,0,644,2747,ITF,ITF6,18,Calabria
2021-01-27 00:00:00,PIE,4196,1453,2743,2983,656,557,0,0,0,999,3197,ITC,ITC1,1,Piemonte
2021-02-18 00:00:00,TOS,8815,3284,5531,2924,1511,228,214,796,3142,7923,892,ITI,ITI1,9,Toscana
2021-03-02 00:00:00,PUG,16186,6009,10177,1380,1055,111,4269,1246,8125,14892,1294,ITF,ITF4,16,Puglia
2021-03-15 00:00:00,PAB,838,292,546,285,478,13,56,2,4,365,473,ITH,ITH1,4,Provincia Autonoma Bolzano / Bozen
2021-02-24 00:00:00,UMB,1520,565,955,1082,46,91,292,9,0,1505,15,ITI,ITI2,10,Umbria
2021-01-14 00:00:00,LIG,2977,1053,1924,1868,555,553,0,0,1,2977,0,ITC,ITC3,7,Liguria
2021-01-18 00:00:00,MAR,673,230,443,370,171,132,0,0,0,547,126,ITI,ITI3,11,Marche
2021-02-06 00:00:00,CAL,2909,1337,1572,2095,567,247,0,0,0,442,2467,ITF,ITF6,18,Calabria
2021-02-27 00:00:00,MOL,1366,568,798,26,40,14,1285,0,1,1347,19,ITF,ITF2,14,Molise
2021-01-04 00:00:00,VEN,6726,2029,4697,5238,569,913,1,0,5,6726,0,ITH,ITH3,5,Veneto
2021-03-10 00:00:00,MOL,1717,716,1001,188,831,1,1,187,509,1667,50,ITF,ITF2,14,Molise
2021-02-02 00:00:00,PAB,1731,500,1231,617,500,605,9,0,0,8,1723,ITH,ITH1,4,Provincia Autonoma Bolzano / Bozen
2021-03-01 00:00:00,FVG,2840,998,1842,82,97,164,1544,4,949,2799,41,ITH,ITH4,6,Friuli-Venezia Giulia
2021-02-08 00:00:00,PAB,1,1,0,0,1,0,0,0,0,1,0,ITH,ITH1,4,Provincia Autonoma Bolzano / Bozen
2021-01-16 00:00:00,SAR,1492,525,967,1282,209,0,0,0,1,1492,0,ITG,ITG2,20,Sardegna
2021-01-23 00:00:00,PAT,570,330,240,480,2,88,0,0,0,384,186,ITH,ITH2,4,Provincia Autonoma Trento
2021-01-17 00:00:00,SAR,860,277,583,747,113,0,0,0,0,859,1,ITG,ITG2,20,Sardegna
2021-01-24 00:00:00,ABR,50,22,28,49,1,0,0,0,0,6,44,ITF,ITF1,13,Abruzzo
2021-03-13 00:00:00,SIC,11739,5153,6586,1169,3658,493,4613,133,1673,7141,4598,ITG,ITG1,19,Sicilia
2021-02-19 00:00:00,MAR,1971,716,1255,1273,492,203,1,0,2,1836,135,ITI,ITI3,11,Marche
2021-03-17 00:00:00,PAT,2014,776,1238,390,361,55,1202,1,5,1158,856,ITH,ITH2,4,Provincia Autonoma Trento
2021-01-04 00:00:00,PUG,4503,2012,2491,4371,120,11,0,0,1,4503,0,ITF,ITF4,16,Puglia
2021-01-29 00:00:00,FVG,2413,813,1600,1855,321,237,0,0,0,264,2149,ITH,ITH4,6,Friuli-Venezia Giulia
2021-01-06 00:00:00,PIE,3114,1110,2004,2368,433,313,0,0,0,3114,0,ITC,ITC1,1,Piemonte
2021-03-13 00:00:00,BAS,1793,888,905,82,359,46,862,231,213,750,1043,ITF,ITF5,17,Basilicata
2021-03-15 00:00:00,EMR,12544,5624,6920,789,1259,142,9058,777,519,6125,6419,ITH,ITH5,8,Emilia-Romagna
2021-02-16 00:00:00,LIG,2391,948,1443,982,410,283,714,0,2,1998,393,ITC,ITC3,7,Liguria
2021-01-21 00:00:00,TOS,1589,686,903,579,220,790,0,0,0,867,722,ITI,ITI1,9,Toscana
2021-02-06 00:00:00,VDA,289,104,185,170,44,0,74,1,0,92,197,ITC,ITC2,2,Valle d'Aosta / Vall√©e d'Aoste
2021-02-18 00:00:00,MAR,2103,746,1357,1150,549,402,1,0,1,1816,287,ITI,ITI3,11,Marche
2021-01-31 00:00:00,ABR,1502,488,1014,1154,245,103,0,0,0,287,1215,ITF,ITF1,13,Abruzzo
2021-01-10 00:00:00,PAB,2,2,0,1,1,0,0,0,0,2,0,ITH,ITH1,4,Provincia Autonoma Bolzano / Bozen
2021-01-20 00:00:00,FVG,750,323,427,719,31,0,0,0,0,12,738,ITH,ITH4,6,Friuli-Venezia Giulia
2021-01-23 00:00:00,EMR,2443,868,1575,1899,114,430,0,0,0,441,2002,ITH,ITH5,8,Emilia-Romagna
2021-01-28 00:00:00,CAM,8832,4122,4710,6216,2269,347,0,0,0,135,8697,ITF,ITF3,15,Campania
2021-03-07 00:00:00,EMR,6528,2433,4095,1452,737,22,2555,513,1249,5013,1515,ITH,ITH5,8,Emilia-Romagna
2021-01-12 00:00:00,LIG,2393,862,1531,1726,269,396,0,0,2,2393,0,ITC,ITC3,7,Liguria
2021-01-29 00:00:00,SIC,9360,4321,5039,7151,1904,305,0,0,0,432,8928,ITG,ITG1,19,Sicilia
2021-01-22 00:00:00,SIC,1235,625,610,1035,82,118,0,0,0,242,993,ITG,ITG1,19,Sicilia
2021-02-19 00:00:00,PAT,901,347,554,169,53,70,580,1,28,844,57,ITH,ITH2,4,Provincia Autonoma Trento
2021-02-12 00:00:00,LAZ,6494,2645,3849,1995,423,302,3774,0,0,6417,77,ITI,ITI4,12,Lazio
2021-01-19 00:00:00,CAM,1095,474,621,534,390,171,0,0,0,1092,3,ITF,ITF3,15,Campania
2021-01-05 00:00:00,CAL,1350,618,732,1256,94,0,0,0,0,1350,0,ITF,ITF6,18,Calabria
2021-01-13 00:00:00,PIE,10078,3222,6856,6484,2265,1329,0,0,0,10078,0,ITC,ITC1,1,Piemonte
2021-03-11 00:00:00,LOM,34279,12891,21388,5616,4477,2046,14841,1216,6083,24865,9414,ITC,ITC4,3,Lombardia
2021-01-19 00:00:00,PAT,403,77,326,363,4,36,0,0,0,403,0,ITH,ITH2,4,Provincia Autonoma Trento
2021-02-05 00:00:00,ABR,1535,520,1015,1188,241,106,0,0,0,788,747,ITF,ITF1,13,Abruzzo
2021-02-02 00:00:00,LOM,19805,6567,13238,13480,4562,1679,76,7,1,489,19316,ITC,ITC4,3,Lombardia
2021-02-11 00:00:00,VEN,4021,1244,2777,2613,596,800,9,1,2,3392,629,ITH,ITH3,5,Veneto
2021-02-08 00:00:00,LIG,1858,716,1142,1224,385,242,0,0,7,306,1552,ITC,ITC3,7,Liguria
2021-03-11 00:00:00,CAM,17523,8635,8888,1009,5223,105,7629,986,2571,10245,7278,ITF,ITF3,15,Campania
2021-01-25 00:00:00,LAZ,7761,3041,4720,7006,270,363,122,0,0,421,7340,ITI,ITI4,12,Lazio
2021-01-20 00:00:00,LOM,5576,1363,4213,2741,1219,1557,59,0,0,5461,115,ITC,ITC4,3,Lombardia
2021-01-05 00:00:00,FVG,1679,550,1129,1349,133,197,0,0,0,1679,0,ITH,ITH4,6,Friuli-Venezia Giulia
2021-03-02 00:00:00,EMR,11582,3804,7778,1921,785,221,5267,355,3033,9608,1974,ITH,ITH5,8,Emilia-Romagna
2021-02-19 00:00:00,TOS,8284,2943,5341,2966,1234,230,154,580,3120,7777,507,ITI,ITI1,9,Toscana
2021-02-19 00:00:00,PUG,4717,2007,2710,3032,1237,390,2,49,7,4327,390,ITF,ITF4,16,Puglia
2021-03-18 00:00:00,SIC,14102,6994,7108,1280,6805,597,5331,55,34,8395,5707,ITG,ITG1,19,Sicilia
2021-01-16 00:00:00,CAL,2394,1120,1274,1664,489,241,0,0,0,2394,0,ITF,ITF6,18,Calabria
2021-01-16 00:00:00,FVG,1231,360,871,771,212,248,0,0,0,1231,0,ITH,ITH4,6,Friuli-Venezia Giulia
2021-02-03 00:00:00,BAS,666,300,366,425,69,172,0,0,0,32,634,ITF,ITF5,17,Basilicata
2021-02-26 00:00:00,LAZ,12805,5579,7226,1908,1331,323,5119,1385,2739,11587,1218,ITI,ITI4,12,Lazio
2021-02-02 00:00:00,CAM,5722,2804,2918,3640,1728,354,0,0,0,443,5279,ITF,ITF3,15,Campania
2021-01-21 00:00:00,MAR,896,253,643,460,100,336,0,0,0,585,311,ITI,ITI3,11,Marche
2021-03-05 00:00:00,VDA,275,124,151,50,69,13,138,0,5,53,222,ITC,ITC2,2,Valle d'Aosta / Vall√©e d'Aoste
2021-03-13 00:00:00,EMR,15656,6075,9581,1245,1281,73,8217,886,3954,10370,5286,ITH,ITH5,8,Emilia-Romagna
2021-01-28 00:00:00,PAT,530,147,383,390,33,107,0,0,0,48,482,ITH,ITH2,4,Provincia Autonoma Trento
2021-02-17 00:00:00,LAZ,8807,4370,4437,2282,432,499,4248,1345,1,8279,528,ITI,ITI4,12,Lazio
2021-01-24 00:00:00,CAL,44,18,26,15,3,26,0,0,0,39,5,ITF,ITF6,18,Calabria
2021-02-10 00:00:00,MOL,150,78,72,91,6,53,0,0,0,130,20,ITF,ITF2,14,Molise
2021-01-14 00:00:00,EMR,8085,2573,5512,5390,1088,1606,0,1,0,8085,0,ITH,ITH5,8,Emilia-Romagna
2021-01-03 00:00:00,BAS,900,344,556,790,108,0,0,0,2,900,0,ITF,ITF5,17,Basilicata
2021-01-02 00:00:00,LOM,199,72,127,178,21,0,0,0,0,199,0,ITC,ITC4,3,Lombardia
2021-01-16 00:00:00,VDA,236,80,156,127,36,22,51,0,0,236,0,ITC,ITC2,2,Valle d'Aosta / Vall√©e d'Aoste
2021-01-30 00:00:00,BAS,703,226,477,424,153,126,0,0,0,127,576,ITF,ITF5,17,Basilicata
2020-12-28 00:00:00,PIE,1,1,0,1,0,0,0,0,0,1,0,ITC,ITC1,1,Piemonte
2021-01-18 00:00:00,MOL,114,48,66,97,17,0,0,0,0,114,0,ITF,ITF2,14,Molise
2021-01-02 00:00:00,CAL,165,94,71,165,0,0,0,0,0,165,0,ITF,ITF6,18,Calabria
2021-01-17 00:00:00,UMB,54,17,37,47,7,0,0,0,0,54,0,ITI,ITI2,10,Umbria
2021-01-30 00:00:00,ABR,1509,566,943,1348,114,47,0,0,0,69,1440,ITF,ITF1,13,Abruzzo
2021-02-03 00:00:00,PAT,845,313,532,354,25,73,393,0,0,414,431,ITH,ITH2,4,Provincia Autonoma Trento
2021-01-14 00:00:00,VEN,7052,1924,5128,3227,1333,2473,17,0,2,7052,0,ITH,ITH3,5,Veneto
2021-01-03 00:00:00,PUG,2004,942,1062,1814,44,145,0,0,1,2004,0,ITF,ITF4,16,Puglia
2021-03-16 00:00:00,LIG,5749,2517,3232,827,490,177,4247,3,5,2297,3452,ITC,ITC3,7,Liguria
2021-01-03 00:00:00,PIE,3061,966,2095,2714,295,52,0,0,0,3061,0,ITC,ITC1,1,Piemonte
2021-03-14 00:00:00,SIC,8240,3680,4560,565,2574,176,4261,34,630,4400,3840,ITG,ITG1,19,Sicilia
2021-02-03 00:00:00,UMB,725,174,551,560,37,128,0,0,0,67,658,ITI,ITI2,10,Umbria
2021-03-07 00:00:00,PAT,21,6,15,0,0,0,0,0,21,21,0,ITH,ITH2,4,Provincia Autonoma Trento
2021-01-13 00:00:00,PAT,420,123,297,391,6,23,0,0,0,420,0,ITH,ITH2,4,Provincia Autonoma Trento
2021-02-21 00:00:00,ABR,1220,551,669,2,4,3,1209,2,0,1219,1,ITF,ITF1,13,Abruzzo
2021-01-09 00:00:00,VDA,443,199,244,225,196,22,0,0,0,443,0,ITC,ITC2,2,Valle d'Aosta / Vall√©e d'Aoste
2021-02-16 00:00:00,VDA,325,53,272,10,58,12,5,4,236,320,5,ITC,ITC2,2,Valle d'Aosta / Vall√©e d'Aoste
2021-01-01 00:00:00,LOM,24,7,17,24,0,0,0,0,0,24,0,ITC,ITC4,3,Lombardia
2021-02-21 00:00:00,VDA,18,3,15,0,0,18,0,0,0,0,18,ITC,ITC2,2,Valle d'Aosta / Vall√©e d'Aoste
2021-01-21 00:00:00,VDA,33,12,21,0,0,33,0,0,0,33,0,ITC,ITC2,2,Valle d'Aosta / Vall√©e d'Aoste
2021-01-04 00:00:00,CAL,996,492,504,969,27,0,0,0,0,996,0,ITF,ITF6,18,Calabria
2021-03-07 00:00:00,UMB,844,180,664,16,83,25,44,0,676,837,7,ITI,ITI2,10,Umbria
2021-02-10 00:00:00,UMB,715,349,366,606,106,3,0,0,0,700,15,ITI,ITI2,10,Umbria
2021-02-06 00:00:00,CAM,5341,2665,2676,1990,2877,459,15,0,0,2103,3238,ITF,ITF3,15,Campania
2021-01-14 00:00:00,SAR,1105,426,679,885,220,0,0,0,0,1105,0,ITG,ITG2,20,Sardegna
2021-01-24 00:00:00,EMR,2443,884,1559,2079,114,250,0,0,0,300,2143,ITH,ITH5,8,Emilia-Romagna
2021-01-09 00:00:00,MAR,1709,605,1104,1406,303,0,0,0,0,1709,0,ITI,ITI3,11,Marche
2021-01-03 00:00:00,ABR,471,185,286,464,7,0,0,0,0,471,0,ITF,ITF1,13,Abruzzo
2021-02-16 00:00:00,TOS,9267,3338,5929,5083,982,178,10,691,2323,8556,711,ITI,ITI1,9,Toscana
2021-03-15 00:00:00,ABR,3516,1377,2139,656,569,78,1963,41,209,1701,1815,ITF,ITF1,13,Abruzzo
2021-02-22 00:00:00,MOL,265,129,136,56,139,62,8,0,0,250,15,ITF,ITF2,14,Molise
2021-03-15 00:00:00,FVG,3628,1590,2038,317,319,152,2372,234,234,1397,2231,ITH,ITH4,6,Friuli-Venezia Giulia
2021-02-13 00:00:00,VEN,3260,1472,1788,1558,665,1034,2,0,1,3246,14,ITH,ITH3,5,Veneto
2021-01-10 00:00:00,CAM,8165,3736,4429,5179,2889,97,0,0,0,8165,0,ITF,ITF3,15,Campania
2021-02-12 00:00:00,MAR,1583,618,965,815,680,88,0,0,0,1431,152,ITI,ITI3,11,Marche
2021-02-03 00:00:00,ABR,2061,717,1344,1541,402,118,0,0,0,419,1642,ITF,ITF1,13,Abruzzo
2021-02-12 00:00:00,SIC,4744,1852,2892,2299,1802,643,0,0,0,4413,331,ITG,ITG1,19,Sicilia
2021-02-07 00:00:00,LOM,7172,2793,4379,5540,1345,263,17,2,5,339,6833,ITC,ITC4,3,Lombardia
2021-01-27 00:00:00,SIC,7531,3835,3696,6329,1050,152,0,0,0,189,7342,ITG,ITG1,19,Sicilia
2020-12-31 00:00:00,FVG,1053,384,669,1011,42,0,0,0,0,1053,0,ITH,ITH4,6,Friuli-Venezia Giulia
2021-02-27 00:00:00,LAZ,11344,4240,7104,1358,884,515,4764,1120,2703,10391,953,ITI,ITI4,12,Lazio
2021-03-06 00:00:00,VDA,22,4,18,13,0,5,4,0,0,22,0,ITC,ITC2,2,Valle d'Aosta / Vall√©e d'Aoste
2021-03-02 00:00:00,CAL,4131,2390,1741,705,735,427,1390,872,2,3422,709,ITF,ITF6,18,Calabria
2021-03-04 00:00:00,EMR,16254,5293,10961,2594,1177,239,6346,511,5387,13263,2991,ITH,ITH5,8,Emilia-Romagna
2021-02-02 00:00:00,CAL,2289,1112,1177,1863,351,75,0,0,0,177,2112,ITF,ITF6,18,Calabria
2021-01-24 00:00:00,VEN,4115,1219,2896,3751,138,222,1,0,3,28,4087,ITH,ITH3,5,Veneto
2021-01-05 00:00:00,PAT,707,231,476,494,52,161,0,0,0,707,0,ITH,ITH2,4,Provincia Autonoma Trento
2021-03-01 00:00:00,TOS,4295,1611,2684,3188,601,136,2,343,25,660,3635,ITI,ITI1,9,Toscana
2021-03-13 00:00:00,UMB,1731,524,1207,120,182,49,152,77,1151,1486,245,ITI,ITI2,10,Umbria
2021-01-09 00:00:00,TOS,4484,1596,2888,3779,144,560,1,0,0,4484,0,ITI,ITI1,9,Toscana
2021-01-12 00:00:00,SAR,865,408,457,504,361,0,0,0,0,865,0,ITG,ITG2,20,Sardegna
2021-01-31 00:00:00,PUG,1805,825,980,1499,104,198,2,0,2,73,1732,ITF,ITF4,16,Puglia
2021-01-28 00:00:00,ABR,1433,495,938,1370,62,1,0,0,0,12,1421,ITF,ITF1,13,Abruzzo
2021-02-08 00:00:00,MOL,334,141,193,206,43,85,0,0,0,216,118,ITF,ITF2,14,Molise
2021-01-04 00:00:00,FVG,1510,559,951,1392,118,0,0,0,0,1510,0,ITH,ITH4,6,Friuli-Venezia Giulia
2021-01-15 00:00:00,BAS,813,350,463,578,61,174,0,0,0,813,0,ITF,ITF5,17,Basilicata
2021-01-18 00:00:00,UMB,588,215,373,315,149,124,0,0,0,504,84,ITI,ITI2,10,Umbria
2021-01-13 00:00:00,UMB,450,139,311,379,29,42,0,0,0,450,0,ITI,ITI2,10,Umbria
2021-02-17 00:00:00,VDA,327,144,183,25,19,30,237,16,0,227,100,ITC,ITC2,2,Valle d'Aosta / Vall√©e d'Aoste
2021-01-23 00:00:00,SAR,60,22,38,60,0,0,0,0,0,0,60,ITG,ITG2,20,Sardegna
2021-01-04 00:00:00,MOL,314,131,183,301,13,0,0,0,0,314,0,ITF,ITF2,14,Molise
2021-03-06 00:00:00,PIE,13953,5195,8758,2260,1120,455,7426,0,2692,11170,2783,ITC,ITC1,1,Piemonte
2021-02-27 00:00:00,PAT,1021,454,567,444,28,0,434,4,111,598,423,ITH,ITH2,4,Provincia Autonoma Trento
2021-02-19 00:00:00,EMR,7283,2999,4284,818,368,257,5840,0,0,6780,503,ITH,ITH5,8,Emilia-Romagna
2021-01-30 00:00:00,LIG,1661,567,1094,1261,141,257,0,0,2,25,1636,ITC,ITC3,7,Liguria
2021-02-01 00:00:00,PAT,1217,334,883,765,78,374,0,0,0,92,1125,ITH,ITH2,4,Provincia Autonoma Trento
2021-02-16 00:00:00,BAS,905,377,528,250,95,67,492,1,0,807,98,ITF,ITF5,17,Basilicata
2021-03-16 00:00:00,SAR,3753,1661,2092,636,806,311,1992,0,8,2822,931,ITG,ITG2,20,Sardegna
2021-02-25 00:00:00,UMB,1334,495,839,826,101,97,305,0,5,1282,52,ITI,ITI2,10,Umbria
2021-02-18 00:00:00,ABR,2291,934,1357,670,380,416,610,215,0,2161,130,ITF,ITF1,13,Abruzzo
2021-03-13 00:00:00,TOS,9254,3282,5972,2833,2109,54,174,344,3740,5308,3946,ITI,ITI1,9,Toscana
2021-03-02 00:00:00,SIC,14945,6384,8561,2380,1927,500,4467,1338,4333,12126,2819,ITG,ITG1,19,Sicilia
2021-02-06 00:00:00,LIG,1891,767,1124,1309,206,375,0,0,1,145,1746,ITC,ITC3,7,Liguria
2021-01-28 00:00:00,MAR,1973,659,1314,1581,291,101,0,0,0,167,1806,ITI,ITI3,11,Marche
2021-03-16 00:00:00,PAB,620,245,375,22,63,38,497,0,0,103,517,ITH,ITH1,4,Provincia Autonoma Bolzano / Bozen
2021-02-27 00:00:00,BAS,1982,854,1128,103,184,21,1674,0,0,1818,164,ITF,ITF5,17,Basilicata
2021-02-20 00:00:00,PUG,2955,1075,1880,2110,244,167,6,4,424,2699,256,ITF,ITF4,16,Puglia
2021-02-19 00:00:00,ABR,3301,1552,1749,990,433,371,1111,388,8,3201,100,ITF,ITF1,13,Abruzzo
2021-03-12 00:00:00,PAT,2385,897,1488,205,345,85,1025,203,522,1605,780,ITH,ITH2,4,Provincia Autonoma Trento
2021-01-07 00:00:00,PUG,5707,2448,3259,5210,276,217,0,1,3,5707,0,ITF,ITF4,16,Puglia
2021-01-08 00:00:00,VEN,9397,2831,6566,5977,1603,1807,3,1,6,9397,0,ITH,ITH3,5,Veneto
2021-01-25 00:00:00,FVG,1582,567,1015,1369,141,72,0,0,0,194,1388,ITH,ITH4,6,Friuli-Venezia Giulia
2021-02-01 00:00:00,PUG,3957,1656,2301,3439,300,209,0,4,5,375,3582,ITF,ITF4,16,Puglia
2021-03-01 00:00:00,BAS,540,279,261,121,129,4,168,68,50,376,164,ITF,ITF5,17,Basilicata
2021-01-06 00:00:00,BAS,294,129,165,229,29,36,0,0,0,294,0,ITF,ITF5,17,Basilicata
2021-01-26 00:00:00,PAB,809,291,518,681,128,0,0,0,0,1,808,ITH,ITH1,4,Provincia Autonoma Bolzano / Bozen
2021-02-04 00:00:00,BAS,1092,440,652,636,175,281,0,0,0,63,1029,ITF,ITF5,17,Basilicata
2021-01-22 00:00:00,PIE,3864,1248,2616,2279,650,935,0,0,0,2523,1341,ITC,ITC1,1,Piemonte
2021-03-16 00:00:00,VEN,12158,5222,6936,1200,2633,368,7837,17,103,6700,5458,ITH,ITH3,5,Veneto
2021-01-07 00:00:00,PAT,1268,310,958,649,63,556,0,0,0,1268,0,ITH,ITH2,4,Provincia Autonoma Trento
2021-02-15 00:00:00,VDA,264,136,128,24,29,24,170,15,2,229,35,ITC,ITC2,2,Valle d'Aosta / Vall√©e d'Aoste
2021-01-19 00:00:00,LIG,1356,429,927,709,316,328,0,0,3,1266,90,ITC,ITC3,7,Liguria
2021-03-06 00:00:00,CAM,16295,6746,9549,957,4431,171,5827,1027,3882,10629,5666,ITF,ITF3,15,Campania
2021-01-03 00:00:00,PAB,41,16,25,33,7,0,1,0,0,41,0,ITH,ITH1,4,Provincia Autonoma Bolzano / Bozen
2021-03-10 00:00:00,CAM,15226,7362,7864,638,3987,26,7285,1006,2284,8399,6827,ITF,ITF3,15,Campania
2021-03-08 00:00:00,CAM,14502,6703,7799,835,5195,36,4175,1334,2927,9727,4775,ITF,ITF3,15,Campania
2021-02-23 00:00:00,CAM,10988,3383,7605,514,2211,288,3688,0,4287,10462,526,ITF,ITF3,15,Campania
2021-02-25 00:00:00,MOL,541,239,302,68,12,28,433,0,0,473,68,ITF,ITF2,14,Molise
2021-01-05 00:00:00,MOL,449,180,269,441,8,0,0,0,0,449,0,ITF,ITF2,14,Molise
2021-02-06 00:00:00,MOL,429,179,250,276,22,130,0,0,1,29,400,ITF,ITF2,14,Molise
2021-02-14 00:00:00,SAR,539,263,276,286,193,57,3,0,0,537,2,ITG,ITG2,20,Sardegna
2021-01-09 00:00:00,ABR,1483,565,918,1430,53,0,0,0,0,1483,0,ITF,ITF1,13,Abruzzo
2021-01-08 00:00:00,ABR,1525,507,1018,1487,38,0,0,0,0,1525,0,ITF,ITF1,13,Abruzzo
2021-02-03 00:00:00,MOL,731,249,482,391,159,180,0,0,1,338,393,ITF,ITF2,14,Molise
2021-02-17 00:00:00,BAS,1135,493,642,123,69,57,884,1,1,1059,76,ITF,ITF5,17,Basilicata
2020-12-27 00:00:00,PIE,912,368,544,760,76,76,0,0,0,912,0,ITC,ITC1,1,Piemonte
2021-02-19 00:00:00,SAR,1495,470,1025,677,437,379,1,1,0,1439,56,ITG,ITG2,20,Sardegna
2021-01-07 00:00:00,ABR,1603,552,1051,1566,37,0,0,0,0,1603,0,ITF,ITF1,13,Abruzzo
2021-01-21 00:00:00,FVG,894,345,549,863,31,0,0,0,0,1,893,ITH,ITH4,6,Friuli-Venezia Giulia
2021-01-15 00:00:00,MOL,538,242,296,398,59,81,0,0,0,538,0,ITF,ITF2,14,Molise
2021-02-14 00:00:00,VEN,125,56,69,95,30,0,0,0,0,112,13,ITH,ITH3,5,Veneto
2021-03-03 00:00:00,CAM,13921,5495,8426,2017,5280,158,3468,3,2995,7292,6629,ITF,ITF3,15,Campania
2021-01-21 00:00:00,PAB,915,426,489,720,100,68,27,0,0,138,777,ITH,ITH1,4,Provincia Autonoma Bolzano / Bozen
2021-02-14 00:00:00,VDA,48,16,32,6,0,42,0,0,0,1,47,ITC,ITC2,2,Valle d'Aosta / Vall√©e d'Aoste
2021-01-27 00:00:00,VDA,151,71,80,55,25,18,53,0,0,79,72,ITC,ITC2,2,Valle d'Aosta / Vall√©e d'Aoste
2021-02-24 00:00:00,VEN,8541,3655,4886,1522,640,506,5602,260,11,8058,483,ITH,ITH3,5,Veneto
2021-02-06 00:00:00,PUG,4483,1911,2572,3480,487,513,0,0,3,1584,2899,ITF,ITF4,16,Puglia
2021-01-05 00:00:00,EMR,9324,3163,6161,7924,635,765,0,0,0,9324,0,ITH,ITH5,8,Emilia-Romagna
2021-02-07 00:00:00,TOS,2806,953,1853,2349,300,157,0,0,0,885,1921,ITI,ITI1,9,Toscana
2021-02-04 00:00:00,PAT,971,303,668,541,17,89,324,0,0,420,551,ITH,ITH2,4,Provincia Autonoma Trento
2021-03-06 00:00:00,SIC,12845,5144,7701,2002,2000,758,3887,638,3560,9939,2906,ITG,ITG1,19,Sicilia
2021-01-01 00:00:00,LAZ,3553,1381,2172,3483,2,68,0,0,0,3553,0,ITI,ITI4,12,Lazio
2021-02-09 00:00:00,SIC,4370,1831,2539,2240,1490,640,0,0,0,3364,1006,ITG,ITG1,19,Sicilia
2021-02-07 00:00:00,SAR,1116,394,722,975,141,0,0,0,0,228,888,ITG,ITG2,20,Sardegna
2021-03-12 00:00:00,LAZ,22491,9945,12546,4606,3409,400,9354,774,3948,16182,6309,ITI,ITI4,12,Lazio
2021-01-05 00:00:00,TOS,5244,1755,3489,4354,11,879,0,0,0,5244,0,ITI,ITI1,9,Toscana
2021-02-26 00:00:00,CAL,3077,1630,1447,538,688,406,1147,294,4,2610,467,ITF,ITF6,18,Calabria
2021-02-13 00:00:00,CAM,5508,2549,2959,952,808,131,3615,0,2,5291,217,ITF,ITF3,15,Campania
2021-01-12 00:00:00,LAZ,5391,1974,3417,4343,464,584,0,0,0,5391,0,ITI,ITI4,12,Lazio
2021-01-24 00:00:00,LIG,755,236,519,632,63,60,0,0,0,113,642,ITC,ITC3,7,Liguria
2021-02-01 00:00:00,SAR,1524,605,919,896,551,77,0,0,0,225,1299,ITG,ITG2,20,Sardegna
2021-03-12 00:00:00,UMB,2632,1030,1602,110,596,41,463,229,1193,2134,498,ITI,ITI2,10,Umbria
2021-02-17 00:00:00,FVG,2350,997,1353,327,193,229,1555,46,0,1872,478,ITH,ITH4,6,Friuli-Venezia Giulia
2021-02-22 00:00:00,BAS,1790,772,1018,125,86,2,1577,0,0,1737,53,ITF,ITF5,17,Basilicata
2021-01-23 00:00:00,LAZ,6883,2682,4201,6063,278,417,125,0,0,255,6628,ITI,ITI4,12,Lazio
2021-01-04 00:00:00,SAR,591,217,374,565,26,0,0,0,0,591,0,ITG,ITG2,20,Sardegna
2021-03-02 00:00:00,FVG,4215,1516,2699,1164,675,202,1535,5,634,2712,1503,ITH,ITH4,6,Friuli-Venezia Giulia
2021-02-12 00:00:00,VDA,263,96,167,51,50,26,131,0,5,217,46,ITC,ITC2,2,Valle d'Aosta / Vall√©e d'Aoste
2021-01-24 00:00:00,CAM,4128,2123,2005,3140,822,166,0,0,0,383,3745,ITF,ITF3,15,Campania
2021-01-02 00:00:00,EMR,2347,903,1444,2071,79,197,0,0,0,2347,0,ITH,ITH5,8,Emilia-Romagna
2021-03-17 00:00:00,SIC,14023,6786,7237,1386,5923,664,5712,37,301,8082,5941,ITG,ITG1,19,Sicilia
2021-01-17 00:00:00,PUG,1306,589,717,823,147,336,0,0,0,1237,69,ITF,ITF4,16,Puglia
2021-03-08 00:00:00,MOL,1376,522,854,359,514,23,0,76,404,1236,140,ITF,ITF2,14,Molise
2021-02-27 00:00:00,PUG,13876,4693,9183,1576,776,190,4991,344,5999,12703,1173,ITF,ITF4,16,Puglia
2021-01-23 00:00:00,FVG,816,324,492,768,48,0,0,0,0,4,812,ITH,ITH4,6,Friuli-Venezia Giulia
2021-01-07 00:00:00,MOL,598,209,389,414,39,145,0,0,0,598,0,ITF,ITF2,14,Molise
2021-02-04 00:00:00,PUG,5890,2355,3535,4420,812,652,0,0,6,1164,4726,ITF,ITF4,16,Puglia
2021-01-20 00:00:00,EMR,1321,269,1052,391,143,787,0,0,0,1320,1,ITH,ITH5,8,Emilia-Romagna
2021-01-08 00:00:00,TOS,5944,1641,4303,5360,39,545,0,0,0,5944,0,ITI,ITI1,9,Toscana
2021-03-07 00:00:00,FVG,2535,925,1610,1,158,0,143,452,1781,2534,1,ITH,ITH4,6,Friuli-Venezia Giulia
2021-02-22 00:00:00,SIC,8035,4159,3876,1107,935,554,4065,1053,321,7544,491,ITG,ITG1,19,Sicilia
2021-01-16 00:00:00,LAZ,5345,2072,3273,3350,461,1064,470,0,0,5345,0,ITI,ITI4,12,Lazio
2021-02-21 00:00:00,PIE,5086,2080,3006,686,264,47,3352,0,737,4983,103,ITC,ITC1,1,Piemonte
2021-02-05 00:00:00,SIC,7216,3232,3984,3618,2742,856,0,0,0,2132,5084,ITG,ITG1,19,Sicilia
2021-02-13 00:00:00,MAR,1064,455,609,457,517,90,0,0,0,1012,52,ITI,ITI3,11,Marche
2021-02-08 00:00:00,TOS,4095,1358,2737,3373,345,377,0,0,0,3636,459,ITI,ITI1,9,Toscana
2021-01-25 00:00:00,VDA,147,65,82,125,16,6,0,0,0,0,147,ITC,ITC2,2,Valle d'Aosta / Vall√©e d'Aoste
2021-01-10 00:00:00,LOM,10512,3955,6557,8170,2243,85,11,2,1,10512,0,ITC,ITC4,3,Lombardia
2021-01-30 00:00:00,TOS,4620,1622,2998,3763,219,638,0,0,0,197,4423,ITI,ITI1,9,Toscana
2021-03-14 00:00:00,LOM,13516,4733,8783,1493,1324,80,5257,396,4966,10247,3269,ITC,ITC4,3,Lombardia
2021-02-25 00:00:00,ABR,3086,1347,1739,615,557,18,1508,262,126,2558,528,ITF,ITF1,13,Abruzzo
2021-02-10 00:00:00,ABR,948,313,635,622,210,116,0,0,0,504,444,ITF,ITF1,13,Abruzzo
2021-03-03 00:00:00,LOM,26211,11171,15040,6271,6339,1585,9701,1845,470,19155,7056,ITC,ITC4,3,Lombardia
2021-02-28 00:00:00,PIE,10798,4054,6744,641,510,53,6809,0,2785,10558,240,ITC,ITC1,1,Piemonte
2021-01-07 00:00:00,PIE,5385,1739,3646,4158,886,341,0,0,0,5385,0,ITC,ITC1,1,Piemonte
2021-03-14 00:00:00,CAL,2542,1018,1524,322,376,312,802,9,721,2142,400,ITF,ITF6,18,Calabria
2021-01-11 00:00:00,PAB,1501,476,1025,537,640,174,150,0,0,1501,0,ITH,ITH1,4,Provincia Autonoma Bolzano / Bozen
2021-02-09 00:00:00,VEN,5131,1856,3275,3093,869,1149,19,0,1,3422,1709,ITH,ITH3,5,Veneto
2021-03-03 00:00:00,BAS,1741,813,928,191,413,99,589,203,246,1185,556,ITF,ITF5,17,Basilicata
2021-01-11 00:00:00,SIC,5903,2590,3313,3923,1598,382,0,0,0,5903,0,ITG,ITG1,19,Sicilia
2021-01-02 00:00:00,LIG,691,245,446,595,96,0,0,0,0,691,0,ITC,ITC3,7,Liguria
2021-03-03 00:00:00,ABR,4627,1881,2746,1222,583,36,1585,346,855,3721,906,ITF,ITF1,13,Abruzzo
2021-01-02 00:00:00,PAB,91,48,43,69,22,0,0,0,0,91,0,ITH,ITH1,4,Provincia Autonoma Bolzano / Bozen
2021-03-15 00:00:00,MOL,832,338,494,137,271,66,0,61,297,587,245,ITF,ITF2,14,Molise
2021-02-04 00:00:00,LOM,27156,7962,19194,15581,5874,5500,194,7,0,1938,25218,ITC,ITC4,3,Lombardia
2021-01-26 00:00:00,EMR,8325,3000,5325,6599,694,1032,0,0,0,217,8108,ITH,ITH5,8,Emilia-Romagna
2021-01-13 00:00:00,MAR,2105,746,1359,1408,621,76,0,0,0,2105,0,ITI,ITI3,11,Marche
2021-01-11 00:00:00,LIG,2651,990,1661,1989,345,316,0,0,1,2651,0,ITC,ITC3,7,Liguria
2021-03-01 00:00:00,UMB,1510,777,733,114,28,0,1249,118,1,1396,114,ITI,ITI2,10,Umbria
2021-02-09 00:00:00,CAL,2147,904,1243,1422,494,231,0,0,0,948,1199,ITF,ITF6,18,Calabria
2021-01-31 00:00:00,VEN,4740,1550,3190,3676,679,377,4,2,2,393,4347,ITH,ITH3,5,Veneto
2021-01-09 00:00:00,VEN,7926,2537,5389,5174,1163,1573,3,11,2,7926,0,ITH,ITH3,5,Veneto
2021-02-06 00:00:00,MAR,2460,900,1560,1402,643,415,0,0,0,523,1937,ITI,ITI3,11,Marche
2021-01-09 00:00:00,CAL,1916,1036,880,1529,387,0,0,0,0,1916,0,ITF,ITF6,18,Calabria
2021-03-17 00:00:00,VEN,14295,5824,8471,1850,2616,213,8902,26,688,7643,6652,ITH,ITH3,5,Veneto
2021-01-22 00:00:00,PAT,1628,422,1206,874,128,623,0,0,3,317,1311,ITH,ITH2,4,Provincia Autonoma Trento
2021-01-08 00:00:00,CAM,10455,4969,5486,6714,3529,212,0,0,0,10455,0,ITF,ITF3,15,Campania
2021-01-26 00:00:00,SAR,1336,453,883,1296,39,0,0,0,1,27,1309,ITG,ITG2,20,Sardegna
2021-02-04 00:00:00,EMR,9902,3191,6711,6426,1684,1674,118,0,0,1237,8665,ITH,ITH5,8,Emilia-Romagna
2021-02-21 00:00:00,VEN,4624,1203,3421,495,9,18,417,2,3683,4619,5,ITH,ITH3,5,Veneto
2021-01-15 00:00:00,SIC,5079,2233,2846,2824,1776,479,0,0,0,5079,0,ITG,ITG1,19,Sicilia
2021-03-07 00:00:00,SIC,9140,3417,5723,959,961,431,3350,216,3223,8060,1080,ITG,ITG1,19,Sicilia
2021-03-06 00:00:00,BAS,1350,534,816,296,170,57,383,185,259,756,594,ITF,ITF5,17,Basilicata
2021-02-23 00:00:00,ABR,2784,1274,1510,324,423,215,1436,286,100,2773,11,ITF,ITF1,13,Abruzzo
2021-01-18 00:00:00,VDA,213,74,139,29,111,27,46,0,0,213,0,ITC,ITC2,2,Valle d'Aosta / Vall√©e d'Aoste
2021-03-10 00:00:00,ABR,4948,1640,3308,735,455,242,1518,127,1871,3992,956,ITF,ITF1,13,Abruzzo
2021-03-14 00:00:00,VEN,14485,5568,8917,2087,4782,85,4135,129,3267,13759,726,ITH,ITH3,5,Veneto
2021-01-05 00:00:00,UMB,850,428,422,845,5,0,0,0,0,850,0,ITI,ITI2,10,Umbria
2021-03-08 00:00:00,PAT,1385,431,954,65,45,0,992,7,276,1025,360,ITH,ITH2,4,Provincia Autonoma Trento
2021-02-28 00:00:00,SAR,367,169,198,244,76,47,0,0,0,141,226,ITG,ITG2,20,Sardegna
2020-12-28 00:00:00,SIC,207,124,83,205,2,0,0,0,0,207,0,ITG,ITG1,19,Sicilia
2021-02-24 00:00:00,PAT,1315,522,793,237,11,28,972,1,66,922,393,ITH,ITH2,4,Provincia Autonoma Trento
2021-02-16 00:00:00,PAT,663,244,419,73,14,3,563,0,10,658,5,ITH,ITH2,4,Provincia Autonoma Trento
2021-02-19 00:00:00,MOL,169,93,76,95,70,1,0,0,3,167,2,ITF,ITF2,14,Molise
2021-01-28 00:00:00,MOL,613,217,396,430,28,154,0,0,1,17,596,ITF,ITF2,14,Molise
2020-12-30 00:00:00,PAB,384,181,203,340,44,0,0,0,0,384,0,ITH,ITH1,4,Provincia Autonoma Bolzano / Bozen
2021-03-07 00:00:00,VDA,64,30,34,16,19,0,26,2,1,11,53,ITC,ITC2,2,Valle d'Aosta / Vall√©e d'Aoste
2021-01-22 00:00:00,BAS,67,24,43,6,60,0,1,0,0,67,0,ITF,ITF5,17,Basilicata
2021-01-03 00:00:00,FVG,312,122,190,285,26,1,0,0,0,312,0,ITH,ITH4,6,Friuli-Venezia Giulia
2021-03-07 00:00:00,PIE,11940,4643,7297,1321,1137,107,7326,0,2049,11061,879,ITC,ITC1,1,Piemonte
2021-01-17 00:00:00,LOM,8223,3313,4910,5535,2436,211,36,5,0,8023,200,ITC,ITC4,3,Lombardia
2021-01-11 00:00:00,CAM,4072,1871,2201,2386,1434,252,0,0,0,4072,0,ITF,ITF3,15,Campania
2021-03-04 00:00:00,PAB,1669,988,681,293,598,25,40,452,261,1457,212,ITH,ITH1,4,Provincia Autonoma Bolzano / Bozen
2021-02-08 00:00:00,EMR,5185,1519,3666,2827,693,1478,186,0,1,2290,2895,ITH,ITH5,8,Emilia-Romagna
2021-02-05 00:00:00,FVG,2613,784,1829,1612,511,490,0,0,0,90,2523,ITH,ITH4,6,Friuli-Venezia Giulia
2021-03-10 00:00:00,LAZ,21720,9349,12371,3993,2626,449,8857,1179,4616,16097,5623,ITI,ITI4,12,Lazio
2021-02-16 00:00:00,CAL,1534,643,891,659,517,240,118,0,0,1255,279,ITF,ITF6,18,Calabria
2021-03-18 00:00:00,MAR,3443,1513,1930,325,263,123,2653,76,3,216,3227,ITI,ITI3,11,Marche
2021-01-05 00:00:00,ABR,1614,604,1010,1604,10,0,0,0,0,1614,0,ITF,ITF1,13,Abruzzo
2021-02-16 00:00:00,PUG,3378,1450,1928,2133,810,413,4,16,2,2733,645,ITF,ITF4,16,Puglia
2021-03-04 00:00:00,MOL,850,417,433,252,493,69,0,36,0,526,324,ITF,ITF2,14,Molise
2021-02-09 00:00:00,PAB,317,126,191,64,22,2,227,0,2,1,316,ITH,ITH1,4,Provincia Autonoma Bolzano / Bozen
2021-01-08 00:00:00,PIE,5528,1761,3767,4078,1029,421,0,0,0,5528,0,ITC,ITC1,1,Piemonte
2020-12-31 00:00:00,PIE,3907,1332,2575,3413,360,134,0,0,0,3907,0,ITC,ITC1,1,Piemonte
2021-02-24 00:00:00,CAM,11768,4143,7625,712,2311,145,5096,0,3504,11080,688,ITF,ITF3,15,Campania
2021-02-12 00:00:00,EMR,5308,1676,3632,3391,908,704,305,0,0,3908,1400,ITH,ITH5,8,Emilia-Romagna
2021-03-09 00:00:00,TOS,10404,3985,6419,4805,2078,151,3217,142,11,4851,5553,ITI,ITI1,9,Toscana
2021-02-04 00:00:00,LIG,2813,984,1829,1865,468,471,0,1,8,179,2634,ITC,ITC3,7,Liguria
2021-02-25 00:00:00,MAR,3562,1446,2116,432,213,423,2490,3,1,3383,179,ITI,ITI3,11,Marche
2021-03-14 00:00:00,SAR,603,374,229,34,236,0,248,73,12,603,0,ITG,ITG2,20,Sardegna
2021-02-20 00:00:00,LAZ,8784,4078,4706,1941,461,298,4752,1310,22,8367,417,ITI,ITI4,12,Lazio
2021-02-27 00:00:00,TOS,1944,722,1222,1353,314,132,1,125,19,1042,902,ITI,ITI1,9,Toscana
2021-03-17 00:00:00,PAB,567,211,356,7,38,42,480,0,0,566,1,ITH,ITH1,4,Provincia Autonoma Bolzano / Bozen
2021-01-17 00:00:00,LIG,861,300,561,516,82,262,0,0,1,861,0,ITC,ITC3,7,Liguria
2021-01-25 00:00:00,TOS,5124,1896,3228,4159,56,909,0,0,0,248,4876,ITI,ITI1,9,Toscana
2021-01-28 00:00:00,UMB,1240,392,848,891,4,345,0,0,0,19,1221,ITI,ITI2,10,Umbria
2021-01-16 00:00:00,BAS,721,304,417,466,92,161,0,0,2,721,0,ITF,ITF5,17,Basilicata
2021-01-10 00:00:00,VEN,5020,1662,3358,3839,715,462,2,2,0,5020,0,ITH,ITH3,5,Veneto
2021-03-01 00:00:00,EMR,9979,3538,6441,1817,597,432,5582,309,1242,7740,2239,ITH,ITH5,8,Emilia-Romagna
2020-12-27 00:00:00,MAR,200,97,103,184,12,4,0,0,0,200,0,ITI,ITI3,11,Marche
2021-02-28 00:00:00,CAM,10400,3204,7196,485,3656,22,1943,0,4294,8501,1899,ITF,ITF3,15,Campania
2021-01-29 00:00:00,LOM,13431,4111,9320,10480,2369,573,9,0,0,653,12778,ITC,ITC4,3,Lombardia
2021-02-07 00:00:00,PIE,3087,974,2113,1649,662,776,0,0,0,445,2642,ITC,ITC1,1,Piemonte
2021-01-10 00:00:00,UMB,1056,275,781,740,9,307,0,0,0,1056,0,ITI,ITI2,10,Umbria
2021-02-24 00:00:00,LOM,14548,5887,8661,3567,1745,1779,6252,1181,24,13626,922,ITC,ITC4,3,Lombardia
2021-03-14 00:00:00,FVG,1357,537,820,0,8,0,243,332,774,1109,248,ITH,ITH4,6,Friuli-Venezia Giulia
2021-01-23 00:00:00,LIG,809,295,514,633,132,43,0,0,1,153,656,ITC,ITC3,7,Liguria
2021-03-17 00:00:00,UMB,3264,1283,1981,1428,61,70,1681,8,16,1855,1409,ITI,ITI2,10,Umbria
2021-01-17 00:00:00,CAM,1155,551,604,718,286,151,0,0,0,702,453,ITF,ITF3,15,Campania
2021-02-21 00:00:00,CAM,5834,2239,3595,780,653,22,3871,0,508,5609,225,ITF,ITF3,15,Campania
2021-01-15 00:00:00,ABR,379,149,230,223,121,35,0,0,0,379,0,ITF,ITF1,13,Abruzzo
2021-02-10 00:00:00,PAT,849,289,560,310,9,51,479,0,0,509,340,ITH,ITH2,4,Provincia Autonoma Trento
2021-01-02 00:00:00,TOS,3497,1097,2400,2682,15,800,0,0,0,3497,0,ITI,ITI1,9,Toscana
2021-02-08 00:00:00,ABR,1201,398,803,710,227,264,0,0,0,491,710,ITF,ITF1,13,Abruzzo
2021-01-19 00:00:00,BAS,199,84,115,78,77,44,0,0,0,199,0,ITF,ITF5,17,Basilicata
2021-01-14 00:00:00,MOL,646,239,407,418,113,115,0,0,0,646,0,ITF,ITF2,14,Molise
2021-02-28 00:00:00,LIG,1060,581,479,12,571,3,474,0,0,1059,1,ITC,ITC3,7,Liguria
2020-12-30 00:00:00,LIG,12,5,7,12,0,0,0,0,0,12,0,ITC,ITC3,7,Liguria
2021-01-18 00:00:00,ABR,122,48,74,106,14,2,0,0,0,46,76,ITF,ITF1,13,Abruzzo
2021-01-10 00:00:00,PAT,84,19,65,53,19,12,0,0,0,84,0,ITH,ITH2,4,Provincia Autonoma Trento
2021-03-14 00:00:00,PAT,107,65,42,102,0,0,0,0,5,20,87,ITH,ITH2,4,Provincia Autonoma Trento
2021-02-02 00:00:00,VDA,271,70,201,225,43,3,0,0,0,2,269,ITC,ITC2,2,Valle d'Aosta / Vall√©e d'Aoste
2021-02-08 00:00:00,VDA,223,83,140,28,103,3,64,0,25,25,198,ITC,ITC2,2,Valle d'Aosta / Vall√©e d'Aoste
2021-01-31 00:00:00,PAT,74,15,59,55,13,6,0,0,0,0,74,ITH,ITH2,4,Provincia Autonoma Trento
2021-03-03 00:00:00,LAZ,17000,7192,9808,2097,1374,374,7969,1249,3937,12710,4290,ITI,ITI4,12,Lazio
2021-01-28 00:00:00,FVG,2235,792,1443,1754,287,194,0,0,0,354,1881,ITH,ITH4,6,Friuli-Venezia Giulia
2021-01-29 00:00:00,PAB,1488,508,980,874,313,295,2,0,4,23,1465,ITH,ITH1,4,Provincia Autonoma Bolzano / Bozen
2021-02-06 00:00:00,BAS,902,367,535,546,187,168,0,0,1,146,756,ITF,ITF5,17,Basilicata
2021-03-02 00:00:00,PAT,1284,432,852,130,43,53,914,0,144,894,390,ITH,ITH2,4,Provincia Autonoma Trento
2021-02-08 00:00:00,UMB,637,203,434,368,112,153,0,4,0,88,549,ITI,ITI2,10,Umbria
2021-01-17 00:00:00,LAZ,4555,1841,2714,3231,336,177,811,0,0,4343,212,ITI,ITI4,12,Lazio
2021-01-15 00:00:00,PAB,3027,1119,1908,560,871,336,1260,0,0,3027,0,ITH,ITH1,4,Provincia Autonoma Bolzano / Bozen
2021-01-31 00:00:00,LOM,9727,3754,5973,7568,2063,87,7,2,0,33,9694,ITC,ITC4,3,Lombardia
2021-02-05 00:00:00,CAL,3795,1709,2086,2327,914,554,0,0,0,488,3307,ITF,ITF6,18,Calabria
2021-02-04 00:00:00,SIC,6877,3159,3718,4417,1920,540,0,0,0,1460,5417,ITG,ITG1,19,Sicilia
2021-01-16 00:00:00,SIC,2776,1195,1581,1329,1149,298,0,0,0,2776,0,ITG,ITG1,19,Sicilia
2021-01-28 00:00:00,PUG,5464,2271,3193,4759,376,327,0,0,2,474,4990,ITF,ITF4,16,Puglia
2021-02-27 00:00:00,VDA,230,84,146,69,30,1,126,4,0,124,106,ITC,ITC2,2,Valle d'Aosta / Vall√©e d'Aoste
2021-02-10 00:00:00,MAR,1439,452,987,881,343,215,0,0,0,1080,359,ITI,ITI3,11,Marche
2021-01-14 00:00:00,CAM,7072,2976,4096,3706,3016,350,0,0,0,7072,0,ITF,ITF3,15,Campania
2021-01-18 00:00:00,VEN,2770,782,1988,1222,541,999,8,0,0,2571,199,ITH,ITH3,5,Veneto
2021-01-27 00:00:00,ABR,1364,515,849,1301,63,0,0,0,0,39,1325,ITF,ITF1,13,Abruzzo
2021-01-09 00:00:00,LIG,1335,481,854,998,147,188,0,0,2,1335,0,ITC,ITC3,7,Liguria
2021-02-09 00:00:00,BAS,491,213,278,200,237,54,0,0,0,316,175,ITF,ITF5,17,Basilicata
2021-03-09 00:00:00,ABR,5169,1795,3374,987,528,84,1320,204,2046,4230,939,ITF,ITF1,13,Abruzzo
2021-01-10 00:00:00,EMR,7124,2662,4462,5641,977,499,6,0,1,7124,0,ITH,ITH5,8,Emilia-Romagna
2020-12-29 00:00:00,LAZ,440,155,285,440,0,0,0,0,0,440,0,ITI,ITI4,12,Lazio
2021-01-17 00:00:00,CAL,867,418,449,527,292,48,0,0,0,801,66,ITF,ITF6,18,Calabria
2020-12-31 00:00:00,VEN,3219,1043,2176,2700,265,252,0,0,2,3219,0,ITH,ITH3,5,Veneto
2021-01-09 00:00:00,PAB,600,317,283,75,439,74,12,0,0,600,0,ITH,ITH1,4,Provincia Autonoma Bolzano / Bozen
2021-02-27 00:00:00,CAL,3679,1913,1766,421,588,395,1971,302,2,3301,378,ITF,ITF6,18,Calabria
2021-02-03 00:00:00,PUG,5027,1999,3028,4362,478,184,0,0,3,728,4299,ITF,ITF4,16,Puglia
2021-03-16 00:00:00,BAS,1899,799,1100,103,58,0,1671,5,62,229,1670,ITF,ITF5,17,Basilicata
2021-02-26 00:00:00,PUG,13397,4875,8522,2087,830,295,4974,597,4614,12379,1018,ITF,ITF4,16,Puglia
2021-01-23 00:00:00,PUG,3036,1291,1745,2522,206,307,0,0,1,885,2151,ITF,ITF4,16,Puglia
2021-02-01 00:00:00,LOM,16022,5305,10717,11655,3420,902,43,1,1,324,15698,ITC,ITC4,3,Lombardia
2021-02-25 00:00:00,CAM,12422,4479,7943,600,2672,124,4916,0,4110,11234,1188,ITF,ITF3,15,Campania
2021-02-01 00:00:00,VEN,8517,2488,6029,4206,1953,2106,245,0,7,165,8352,ITH,ITH3,5,Veneto
2021-01-23 00:00:00,SIC,4149,2147,2002,3912,221,16,0,0,0,225,3924,ITG,ITG1,19,Sicilia
2021-01-12 00:00:00,EMR,9313,3084,6229,6350,1332,1631,0,0,0,9313,0,ITH,ITH5,8,Emilia-Romagna
2021-01-19 00:00:00,VEN,1309,472,837,726,253,324,6,0,0,1160,149,ITH,ITH3,5,Veneto
2021-02-24 00:00:00,SAR,2410,1292,1118,1193,614,301,3,299,0,2221,189,ITG,ITG2,20,Sardegna
2021-01-31 00:00:00,MAR,1927,772,1155,1532,395,0,0,0,0,105,1822,ITI,ITI3,11,Marche
2021-02-15 00:00:00,PIE,4422,1592,2830,2318,1142,960,1,0,1,3217,1205,ITC,ITC1,1,Piemonte
2021-03-03 00:00:00,LIG,4521,1811,2710,1029,242,288,2954,3,5,3528,993,ITC,ITC3,7,Liguria
2021-03-12 00:00:00,VEN,18179,7886,10293,1914,3375,615,8048,755,3472,11507,6672,ITH,ITH3,5,Veneto
2021-01-15 00:00:00,TOS,3878,1347,2531,2758,676,444,0,0,0,3878,0,ITI,ITI1,9,Toscana
2021-01-14 00:00:00,MAR,2010,692,1318,1112,600,298,0,0,0,2010,0,ITI,ITI3,11,Marche
2021-03-13 00:00:00,PAT,830,382,448,200,20,30,39,282,259,780,50,ITH,ITH2,4,Provincia Autonoma Trento
2021-01-09 00:00:00,BAS,557,160,397,386,103,67,0,0,1,557,0,ITF,ITF5,17,Basilicata
2021-01-16 00:00:00,UMB,221,73,148,146,32,43,0,0,0,221,0,ITI,ITI2,10,Umbria
2021-01-22 00:00:00,MOL,126,35,91,21,32,73,0,0,0,126,0,ITF,ITF2,14,Molise
2021-01-02 00:00:00,VDA,6,5,1,0,0,6,0,0,0,6,0,ITC,ITC2,2,Valle d'Aosta / Vall√©e d'Aoste
2021-01-22 00:00:00,VDA,56,21,35,36,0,20,0,0,0,20,36,ITC,ITC2,2,Valle d'Aosta / Vall√©e d'Aoste
2021-02-20 00:00:00,LOM,9385,3879,5506,4275,1110,216,2917,863,4,9092,293,ITC,ITC4,3,Lombardia
2021-02-07 00:00:00,LIG,407,153,254,191,29,187,0,0,0,2,405,ITC,ITC3,7,Liguria
2021-02-17 00:00:00,EMR,6533,2761,3772,803,1278,404,4048,0,0,5760,773,ITH,ITH5,8,Emilia-Romagna
2021-02-24 00:00:00,ABR,3302,1439,1863,391,340,247,1967,226,131,3126,176,ITF,ITF1,13,Abruzzo
2021-03-12 00:00:00,CAL,5092,2438,2654,468,1326,217,1963,333,785,4049,1043,ITF,ITF6,18,Calabria
2021-01-29 00:00:00,ABR,1386,449,937,1290,96,0,0,0,0,74,1312,ITF,ITF1,13,Abruzzo
2021-01-14 00:00:00,PIE,9761,3150,6611,6175,2102,1484,0,0,0,9761,0,ITC,ITC1,1,Piemonte
2021-03-04 00:00:00,VEN,12690,4694,7996,3100,1676,1349,3409,330,2826,9285,3405,ITH,ITH3,5,Veneto
2021-03-01 00:00:00,MAR,3725,1487,2238,387,177,82,2788,5,286,3478,247,ITI,ITI3,11,Marche
2021-01-23 00:00:00,PIE,4219,1321,2898,3190,523,506,0,0,0,878,3341,ITC,ITC1,1,Piemonte
2021-02-15 00:00:00,CAL,1137,538,599,499,412,159,66,0,1,989,148,ITF,ITF6,18,Calabria
2021-01-20 00:00:00,PUG,1550,543,1007,783,165,602,0,0,0,1542,8,ITF,ITF4,16,Puglia
2021-03-02 00:00:00,BAS,792,381,411,110,78,5,185,201,213,657,135,ITF,ITF5,17,Basilicata
2021-02-08 00:00:00,SIC,4086,1759,2327,2346,1343,397,0,0,0,2128,1958,ITG,ITG1,19,Sicilia
2021-02-04 00:00:00,MAR,2342,810,1532,1406,661,275,0,0,0,112,2230,ITI,ITI3,11,Marche
2021-03-11 00:00:00,PAT,2226,828,1398,98,164,41,1497,59,367,1368,858,ITH,ITH2,4,Provincia Autonoma Trento
2021-01-14 00:00:00,BAS,969,413,556,504,142,323,0,0,0,969,0,ITF,ITF5,17,Basilicata
2021-01-18 00:00:00,BAS,463,157,306,364,54,45,0,0,0,364,99,ITF,ITF5,17,Basilicata
2021-01-07 00:00:00,SIC,9173,4239,4934,7694,1269,210,0,0,0,9173,0,ITG,ITG1,19,Sicilia
2021-01-24 00:00:00,LOM,1185,453,732,829,331,24,1,0,0,523,662,ITC,ITC4,3,Lombardia
2021-02-10 00:00:00,SAR,1959,765,1194,1169,301,488,0,0,1,1441,518,ITG,ITG2,20,Sardegna
2021-01-02 00:00:00,PUG,2945,1297,1648,2826,92,23,0,0,4,2945,0,ITF,ITF4,16,Puglia
2021-03-01 00:00:00,VDA,181,66,115,19,15,29,116,2,0,147,34,ITC,ITC2,2,Valle d'Aosta / Vall√©e d'Aoste
2021-03-04 00:00:00,LOM,28781,11903,16878,6884,6799,2026,10777,1919,376,19940,8841,ITC,ITC4,3,Lombardia
2021-03-07 00:00:00,BAS,882,308,574,39,18,4,328,22,471,844,38,ITF,ITF5,17,Basilicata
2021-02-21 00:00:00,PUG,2167,469,1698,535,85,49,30,12,1456,2106,61,ITF,ITF4,16,Puglia
2021-01-11 00:00:00,PUG,3749,1587,2162,3212,357,175,0,3,2,3749,0,ITF,ITF4,16,Puglia
2021-01-29 00:00:00,MOL,421,136,285,227,82,109,0,0,3,6,415,ITF,ITF2,14,Molise
2021-02-18 00:00:00,LAZ,9670,4798,4872,2160,415,473,4956,1665,1,9172,498,ITI,ITI4,12,Lazio
2021-02-03 00:00:00,CAL,2763,1428,1335,2170,490,103,0,0,0,583,2180,ITF,ITF6,18,Calabria
2021-01-16 00:00:00,TOS,3271,1046,2225,2493,538,240,0,0,0,3271,0,ITI,ITI1,9,Toscana
2021-01-01 00:00:00,VEN,1525,470,1055,1494,30,1,0,0,0,1525,0,ITH,ITH3,5,Veneto
2021-02-28 00:00:00,TOS,1648,667,981,1110,202,78,0,249,9,921,727,ITI,ITI1,9,Toscana
2021-02-22 00:00:00,EMR,7461,3080,4381,386,218,129,6728,0,0,7198,263,ITH,ITH5,8,Emilia-Romagna
2021-01-16 00:00:00,PUG,2502,1033,1469,1680,306,515,0,0,1,2502,0,ITF,ITF4,16,Puglia
2021-01-27 00:00:00,UMB,838,329,509,837,1,0,0,0,0,13,825,ITI,ITI2,10,Umbria
2021-02-02 00:00:00,PUG,4312,1828,2484,3606,386,317,0,0,3,583,3729,ITF,ITF4,16,Puglia
2021-03-08 00:00:00,SIC,13413,5747,7666,2000,2104,626,3801,920,3962,10607,2806,ITG,ITG1,19,Sicilia
2021-03-18 00:00:00,MOL,1142,472,670,71,1026,45,0,0,0,678,464,ITF,ITF2,14,Molise
2021-02-13 00:00:00,LIG,1079,508,571,543,135,147,254,0,0,800,279,ITC,ITC3,7,Liguria
2021-02-09 00:00:00,MAR,125,42,83,78,21,26,0,0,0,47,78,ITI,ITI3,11,Marche
2021-01-30 00:00:00,FVG,2271,744,1527,1475,354,442,0,0,0,270,2001,ITH,ITH4,6,Friuli-Venezia Giulia
2021-02-11 00:00:00,PIE,6761,2106,4655,3420,1327,2011,0,0,3,3004,3757,ITC,ITC1,1,Piemonte
2021-02-13 00:00:00,PAB,318,79,239,126,184,7,1,0,0,312,6,ITH,ITH1,4,Provincia Autonoma Bolzano / Bozen
2021-02-19 00:00:00,LAZ,9690,4889,4801,2170,389,408,5053,1636,34,9193,497,ITI,ITI4,12,Lazio
2021-02-03 00:00:00,FVG,2646,790,1856,1701,558,386,1,0,0,23,2623,ITH,ITH4,6,Friuli-Venezia Giulia
2021-01-13 00:00:00,CAL,2028,1022,1006,1800,194,34,0,0,0,2028,0,ITF,ITF6,18,Calabria
2021-03-13 00:00:00,SAR,2677,1035,1642,274,394,147,1686,43,133,2396,281,ITG,ITG2,20,Sardegna
2021-02-22 00:00:00,PAB,520,142,378,338,168,0,4,0,10,510,10,ITH,ITH1,4,Provincia Autonoma Bolzano / Bozen
2021-02-11 00:00:00,BAS,951,401,550,200,169,107,471,4,0,868,83,ITF,ITF5,17,Basilicata
2021-01-08 00:00:00,VDA,299,130,169,240,43,16,0,0,0,299,0,ITC,ITC2,2,Valle d'Aosta / Vall√©e d'Aoste
2021-01-05 00:00:00,VDA,150,54,96,127,12,11,0,0,0,150,0,ITC,ITC2,2,Valle d'Aosta / Vall√©e d'Aoste
2021-03-13 00:00:00,CAL,6653,2933,3720,425,1376,338,3764,65,685,5679,974,ITF,ITF6,18,Calabria
2021-02-24 00:00:00,LIG,3734,1548,2186,796,264,150,2523,0,1,3476,258,ITC,ITC3,7,Liguria
2021-02-24 00:00:00,PAB,1361,403,958,10,3,0,0,8,1340,1349,12,ITH,ITH1,4,Provincia Autonoma Bolzano / Bozen
2021-02-07 00:00:00,CAL,859,428,431,566,212,81,0,0,0,147,712,ITF,ITF6,18,Calabria
2021-02-08 00:00:00,VEN,4966,1538,3428,2790,993,1169,12,0,2,1931,3035,ITH,ITH3,5,Veneto
2021-02-16 00:00:00,SIC,4410,2298,2112,1463,1287,777,25,857,1,3943,467,ITG,ITG1,19,Sicilia
2021-01-20 00:00:00,CAL,1395,622,773,864,352,179,0,0,0,1394,1,ITF,ITF6,18,Calabria
2021-03-11 00:00:00,FVG,3290,1384,1906,249,156,264,2013,104,504,1558,1732,ITH,ITH4,6,Friuli-Venezia Giulia
2021-02-11 00:00:00,LOM,16714,4927,11787,9630,3238,3804,32,4,6,9404,7310,ITC,ITC4,3,Lombardia
2021-02-08 00:00:00,SAR,1470,533,937,998,345,126,1,0,0,856,614,ITG,ITG2,20,Sardegna
2021-03-17 00:00:00,MAR,3435,1497,1938,301,183,117,2822,7,5,111,3324,ITI,ITI3,11,Marche
2021-03-06 00:00:00,MAR,5725,2640,3085,973,831,125,2400,649,747,4457,1268,ITI,ITI3,11,Marche
2021-03-11 00:00:00,CAL,6874,3275,3599,934,2062,570,2379,329,600,5618,1256,ITF,ITF6,18,Calabria
2021-01-27 00:00:00,MOL,674,251,423,436,28,209,0,0,1,8,666,ITF,ITF2,14,Molise
2021-03-01 00:00:00,LAZ,16587,7094,9493,1551,1736,383,7932,1406,3579,12740,3847,ITI,ITI4,12,Lazio
2021-03-18 00:00:00,UMB,2723,1058,1665,940,142,168,1459,3,11,1552,1171,ITI,ITI2,10,Umbria
2021-02-16 00:00:00,LAZ,8043,3862,4181,2058,578,261,4195,950,1,7786,257,ITI,ITI4,12,Lazio
2021-02-13 00:00:00,BAS,799,313,486,279,204,115,199,2,0,738,61,ITF,ITF5,17,Basilicata
2021-03-18 00:00:00,PAB,1281,523,758,49,164,46,1022,0,0,208,1073,ITH,ITH1,4,Provincia Autonoma Bolzano / Bozen
2020-12-30 00:00:00,PAT,6,2,4,4,1,1,0,0,0,6,0,ITH,ITH2,4,Provincia Autonoma Trento
2021-02-11 00:00:00,PAB,1031,408,623,205,381,102,343,0,0,222,809,ITH,ITH1,4,Provincia Autonoma Bolzano / Bozen
2021-03-09 00:00:00,MOL,1329,579,750,199,467,0,52,218,393,1177,152,ITF,ITF2,14,Molise
2021-01-06 00:00:00,LAZ,5096,1951,3145,4619,155,320,0,1,1,5096,0,ITI,ITI4,12,Lazio
2021-01-01 00:00:00,SAR,30,16,14,30,0,0,0,0,0,30,0,ITG,ITG2,20,Sardegna
2021-02-10 00:00:00,PAB,1630,602,1028,489,559,1,581,0,0,26,1604,ITH,ITH1,4,Provincia Autonoma Bolzano / Bozen
2021-02-27 00:00:00,LIG,1886,920,966,139,541,5,1201,0,0,1757,129,ITC,ITC3,7,Liguria
2021-03-14 00:00:00,LAZ,16966,6565,10401,1319,3370,81,8306,445,3445,11832,5134,ITI,ITI4,12,Lazio
2021-03-02 00:00:00,ABR,3963,1676,2287,934,439,53,1856,276,405,3279,684,ITF,ITF1,13,Abruzzo
2021-02-22 00:00:00,SAR,1623,944,679,597,404,180,2,440,0,1395,228,ITG,ITG2,20,Sardegna
2021-02-20 00:00:00,EMR,5309,2100,3209,406,239,155,4509,0,0,5045,264,ITH,ITH5,8,Emilia-Romagna
2021-02-19 00:00:00,VDA,292,102,190,17,30,35,145,0,65,268,24,ITC,ITC2,2,Valle d'Aosta / Vall√©e d'Aoste
2021-03-04 00:00:00,SAR,3880,1888,1992,953,860,462,1091,475,39,2732,1148,ITG,ITG2,20,Sardegna
2021-01-10 00:00:00,PUG,2346,1060,1286,2035,109,202,0,0,0,2346,0,ITF,ITF4,16,Puglia
2021-03-04 00:00:00,PIE,14408,5705,8703,2168,1948,582,7521,0,2189,11496,2912,ITC,ITC1,1,Piemonte
2021-02-10 00:00:00,VEN,4706,1568,3138,3104,857,744,0,0,1,3654,1052,ITH,ITH3,5,Veneto
2021-03-14 00:00:00,TOS,7160,2561,4599,3102,1249,121,2,211,2475,3229,3931,ITI,ITI1,9,Toscana
2021-02-11 00:00:00,UMB,842,349,493,735,99,5,0,0,3,837,5,ITI,ITI2,10,Umbria
2021-02-15 00:00:00,EMR,2890,845,2045,1981,463,157,289,0,0,2764,126,ITH,ITH5,8,Emilia-Romagna
2021-01-24 00:00:00,BAS,834,299,535,706,127,1,0,0,0,58,776,ITF,ITF5,17,Basilicata
2021-01-13 00:00:00,CAM,8019,3665,4354,4350,3082,587,0,0,0,8019,0,ITF,ITF3,15,Campania
2021-01-11 00:00:00,ABR,1551,557,994,1337,166,48,0,0,0,1551,0,ITF,ITF1,13,Abruzzo
2020-12-30 00:00:00,PUG,1,0,1,1,0,0,0,0,0,1,0,ITF,ITF4,16,Puglia
2021-02-26 00:00:00,MOL,563,260,303,42,57,3,406,0,55,490,73,ITF,ITF2,14,Molise
2020-12-30 00:00:00,TOS,327,104,223,34,10,283,0,0,0,327,0,ITI,ITI1,9,Toscana
2021-02-18 00:00:00,VDA,349,153,196,61,41,45,180,14,8,261,88,ITC,ITC2,2,Valle d'Aosta / Vall√©e d'Aoste
2021-01-03 00:00:00,CAM,3837,2009,1828,3191,646,0,0,0,0,3837,0,ITF,ITF3,15,Campania
2021-02-07 00:00:00,PUG,1503,648,855,1014,222,266,0,0,1,252,1251,ITF,ITF4,16,Puglia
2021-02-15 00:00:00,PAB,72,42,30,17,10,40,5,0,0,26,46,ITH,ITH1,4,Provincia Autonoma Bolzano / Bozen
2021-02-14 00:00:00,TOS,8993,2567,6426,3033,5613,81,0,261,5,8883,110,ITI,ITI1,9,Toscana
2021-02-23 00:00:00,LAZ,10864,4669,6195,1896,600,309,5134,1015,1910,10240,624,ITI,ITI4,12,Lazio
2021-03-12 00:00:00,PAB,838,386,452,51,342,41,298,57,49,688,150,ITH,ITH1,4,Provincia Autonoma Bolzano / Bozen
2021-01-21 00:00:00,SIC,1328,647,681,1001,190,137,0,0,0,499,829,ITG,ITG1,19,Sicilia
2021-01-05 00:00:00,PUG,5096,2244,2852,4740,249,98,5,0,4,5096,0,ITF,ITF4,16,Puglia
2021-01-24 00:00:00,PIE,3150,957,2193,2632,372,146,0,0,0,434,2716,ITC,ITC1,1,Piemonte
2021-01-11 00:00:00,FVG,1882,609,1273,1500,336,46,0,0,0,1882,0,ITH,ITH4,6,Friuli-Venezia Giulia
2021-01-29 00:00:00,LIG,3040,1057,1983,2298,311,429,0,0,2,66,2974,ITC,ITC3,7,Liguria
2021-01-21 00:00:00,MOL,6,2,4,0,6,0,0,0,0,6,0,ITF,ITF2,14,Molise
2021-02-22 00:00:00,CAL,1996,1013,983,727,543,166,552,3,5,1441,555,ITF,ITF6,18,Calabria
2021-02-18 00:00:00,SAR,1876,732,1144,1072,362,298,1,33,110,1812,64,ITG,ITG2,20,Sardegna
2021-01-21 00:00:00,CAM,2093,1116,977,1379,639,75,0,0,0,677,1416,ITF,ITF3,15,Campania
2021-02-16 00:00:00,EMR,5728,2427,3301,743,908,437,3640,0,0,5198,530,ITH,ITH5,8,Emilia-Romagna
2021-02-25 00:00:00,PAB,1495,548,947,22,340,0,728,0,405,1494,1,ITH,ITH1,4,Provincia Autonoma Bolzano / Bozen
2021-03-13 00:00:00,LAZ,21110,8286,12824,5026,2474,325,8826,720,3739,15233,5877,ITI,ITI4,12,Lazio
2021-01-12 00:00:00,FVG,2258,712,1546,1527,370,361,0,0,0,2258,0,ITH,ITH4,6,Friuli-Venezia Giulia
2021-01-03 00:00:00,LAZ,5250,1972,3278,5125,60,65,0,0,0,5250,0,ITI,ITI4,12,Lazio
2021-02-18 00:00:00,EMR,7042,2891,4151,891,531,236,5384,0,0,6460,582,ITH,ITH5,8,Emilia-Romagna
2021-03-05 00:00:00,PIE,15231,5935,9296,2537,2004,654,7660,0,2376,11408,3823,ITC,ITC1,1,Piemonte
2021-02-03 00:00:00,LAZ,6288,2348,3940,4620,555,1078,35,0,0,901,5387,ITI,ITI4,12,Lazio
2021-01-08 00:00:00,SAR,3257,1184,2073,2929,328,0,0,0,0,3257,0,ITG,ITG2,20,Sardegna
2021-03-18 00:00:00,PIE,11079,4591,6488,1347,922,163,8629,0,18,3651,7428,ITC,ITC1,1,Piemonte
2021-01-21 00:00:00,PIE,6876,2314,4562,4705,855,1316,0,0,0,3381,3495,ITC,ITC1,1,Piemonte
2021-03-03 00:00:00,PAB,1162,391,771,12,13,6,345,51,735,1149,13,ITH,ITH1,4,Provincia Autonoma Bolzano / Bozen
2021-01-01 00:00:00,PAT,206,48,158,109,11,86,0,0,0,206,0,ITH,ITH2,4,Provincia Autonoma Trento
2021-01-03 00:00:00,SIC,4693,2454,2239,4361,332,0,0,0,0,4693,0,ITG,ITG1,19,Sicilia
2021-02-27 00:00:00,UMB,1658,354,1304,14,11,13,0,60,1560,1642,16,ITI,ITI2,10,Umbria
2021-03-09 00:00:00,CAL,5820,3031,2789,803,1939,419,1768,873,18,4843,977,ITF,ITF6,18,Calabria
2021-01-12 00:00:00,PAT,501,158,343,413,29,59,0,0,0,501,0,ITH,ITH2,4,Provincia Autonoma Trento
2021-02-03 00:00:00,SIC,6100,2856,3244,3356,2120,624,0,0,0,756,5344,ITG,ITG1,19,Sicilia
2020-12-31 00:00:00,LIG,988,354,634,750,55,155,28,0,0,988,0,ITC,ITC3,7,Liguria
2021-03-03 00:00:00,UMB,4435,1771,2664,720,290,86,1517,289,1533,3723,712,ITI,ITI2,10,Umbria
2021-02-23 00:00:00,PIE,9225,3708,5517,2293,1391,389,4100,0,1052,8644,581,ITC,ITC1,1,Piemonte
2021-01-26 00:00:00,SIC,9515,4679,4836,8379,882,254,0,0,0,265,9250,ITG,ITG1,19,Sicilia
2021-01-20 00:00:00,MAR,398,99,299,146,62,190,0,0,0,386,12,ITI,ITI3,11,Marche
2021-03-09 00:00:00,FVG,3860,1590,2270,656,522,196,2002,60,424,1108,2752,ITH,ITH4,6,Friuli-Venezia Giulia
2021-03-11 00:00:00,LIG,6164,2957,3207,1137,614,262,3653,496,2,4159,2005,ITC,ITC3,7,Liguria
2021-03-06 00:00:00,MOL,1728,807,921,156,1415,0,5,152,0,1569,159,ITF,ITF2,14,Molise
2021-02-12 00:00:00,BAS,775,332,443,288,201,90,190,6,0,744,31,ITF,ITF5,17,Basilicata
2021-01-10 00:00:00,MAR,1737,699,1038,1462,275,0,0,0,0,1737,0,ITI,ITI3,11,Marche
2021-01-12 00:00:00,PUG,4202,1765,2437,3628,350,218,1,0,5,4202,0,ITF,ITF4,16,Puglia
2021-02-27 00:00:00,VEN,8958,2687,6271,2169,654,45,1960,12,4118,8126,832,ITH,ITH3,5,Veneto
2021-02-06 00:00:00,LAZ,5069,2015,3054,3270,630,660,509,0,0,769,4300,ITI,ITI4,12,Lazio
2021-02-16 00:00:00,LOM,9362,3060,6302,5809,2247,1271,8,8,19,8912,450,ITC,ITC4,3,Lombardia
2021-01-01 00:00:00,PUG,146,60,86,145,1,0,0,0,0,146,0,ITF,ITF4,16,Puglia
2021-03-14 00:00:00,BAS,1008,477,531,41,123,8,516,71,249,539,469,ITF,ITF5,17,Basilicata
2021-03-09 00:00:00,PAT,1526,571,955,95,66,28,1065,81,191,891,635,ITH,ITH2,4,Provincia Autonoma Trento
2021-01-04 00:00:00,LIG,2516,826,1690,2157,235,121,0,0,3,2516,0,ITC,ITC3,7,Liguria
2021-03-04 00:00:00,PUG,14806,5761,9045,1537,893,318,4558,1229,6271,13431,1375,ITF,ITF4,16,Puglia
2021-01-09 00:00:00,LOM,12376,4558,7818,9498,2675,196,6,1,0,12376,0,ITC,ITC4,3,Lombardia
2021-02-26 00:00:00,PIE,12226,4906,7320,811,1448,487,6584,0,2896,11490,736,ITC,ITC1,1,Piemonte
2021-02-11 00:00:00,PAT,1130,364,766,331,16,48,735,0,0,796,334,ITH,ITH2,4,Provincia Autonoma Trento
2021-01-19 00:00:00,LAZ,4361,1671,2690,2967,562,424,408,0,0,3908,453,ITI,ITI4,12,Lazio
2021-02-18 00:00:00,UMB,1495,582,913,324,16,170,985,0,0,1029,466,ITI,ITI2,10,Umbria
2021-02-05 00:00:00,TOS,5748,2244,3504,4121,1184,442,1,0,0,1924,3824,ITI,ITI1,9,Toscana
2021-02-17 00:00:00,ABR,2076,951,1125,512,241,394,718,210,1,1793,283,ITF,ITF1,13,Abruzzo
2021-02-06 00:00:00,SIC,5066,2225,2841,2535,1939,592,0,0,0,1488,3578,ITG,ITG1,19,Sicilia
2021-01-25 00:00:00,PIE,6209,1938,4271,4782,865,562,0,0,0,982,5227,ITC,ITC1,1,Piemonte
2021-03-18 00:00:00,CAM,12148,5372,6776,444,2490,34,8652,74,454,5967,6181,ITF,ITF3,15,Campania
2021-03-15 00:00:00,LIG,6554,2803,3751,765,1109,10,3647,202,821,4067,2487,ITC,ITC3,7,Liguria
2021-03-05 00:00:00,CAM,16469,6345,10124,1640,5427,64,5028,4,4306,9811,6658,ITF,ITF3,15,Campania
2021-01-08 00:00:00,UMB,1173,337,836,926,9,238,0,0,0,1173,0,ITI,ITI2,10,Umbria
2021-01-13 00:00:00,ABR,1253,440,813,1103,150,0,0,0,0,1253,0,ITF,ITF1,13,Abruzzo
2021-02-27 00:00:00,MAR,3373,1440,1933,186,172,161,2847,6,1,3164,209,ITI,ITI3,11,Marche
2021-01-10 00:00:00,VDA,220,71,149,172,29,19,0,0,0,220,0,ITC,ITC2,2,Valle d'Aosta / Vall√©e d'Aoste
2021-02-23 00:00:00,LIG,3796,1560,2236,682,271,113,2727,2,1,3687,109,ITC,ITC3,7,Liguria
2021-02-01 00:00:00,EMR,10289,3595,6694,7446,1584,1259,0,0,0,366,9923,ITH,ITH5,8,Emilia-Romagna
2021-02-02 00:00:00,PAT,889,237,652,507,47,171,164,0,0,190,699,ITH,ITH2,4,Provincia Autonoma Trento
2021-01-10 00:00:00,FVG,2941,919,2022,1745,951,245,0,0,0,2941,0,ITH,ITH4,6,Friuli-Venezia Giulia
2021-01-06 00:00:00,MAR,2181,792,1389,1738,296,147,0,0,0,2181,0,ITI,ITI3,11,Marche
2021-01-13 00:00:00,FVG,2651,834,1817,1822,599,230,0,0,0,2651,0,ITH,ITH4,6,Friuli-Venezia Giulia
2021-01-19 00:00:00,CAL,1109,488,621,853,180,76,0,0,0,1098,11,ITF,ITF6,18,Calabria
2021-02-04 00:00:00,TOS,4251,1594,2657,3166,624,456,5,0,0,961,3290,ITI,ITI1,9,Toscana
2021-03-05 00:00:00,MOL,1219,649,570,322,673,0,0,151,73,1015,204,ITF,ITF2,14,Molise
2021-01-23 00:00:00,CAL,400,186,214,325,52,23,0,0,0,358,42,ITF,ITF6,18,Calabria
2021-01-10 00:00:00,CAL,929,524,405,830,99,0,0,0,0,929,0,ITF,ITF6,18,Calabria
2021-01-23 00:00:00,BAS,707,299,408,592,114,1,0,0,0,33,674,ITF,ITF5,17,Basilicata
2021-02-17 00:00:00,LIG,2622,1165,1457,882,362,262,1115,0,1,2259,363,ITC,ITC3,7,Liguria
2021-01-15 00:00:00,PUG,4545,1860,2685,3592,388,558,0,3,4,4545,0,ITF,ITF4,16,Puglia
2021-03-14 00:00:00,MAR,2515,1036,1479,442,80,0,1535,2,456,1917,598,ITI,ITI3,11,Marche
2021-01-31 00:00:00,TOS,3048,1129,1919,2465,135,448,0,0,0,105,2943,ITI,ITI1,9,Toscana
2021-03-14 00:00:00,VDA,390,200,190,6,298,0,0,34,52,390,0,ITC,ITC2,2,Valle d'Aosta / Vall√©e d'Aoste
2021-03-06 00:00:00,LIG,3243,1818,1425,373,788,120,1490,472,0,2538,705,ITC,ITC3,7,Liguria
2021-01-25 00:00:00,LIG,2717,888,1829,2208,190,317,0,0,2,471,2246,ITC,ITC3,7,Liguria
2021-02-23 00:00:00,MAR,3274,1400,1874,219,137,116,2794,8,0,3218,56,ITI,ITI3,11,Marche
2021-01-06 00:00:00,VDA,65,33,32,29,18,18,0,0,0,65,0,ITC,ITC2,2,Valle d'Aosta / Vall√©e d'Aoste
2021-01-09 00:00:00,SIC,7325,3424,3901,5034,1835,456,0,0,0,7325,0,ITG,ITG1,19,Sicilia
2021-01-30 00:00:00,LOM,12309,4565,7744,9902,2237,160,8,1,1,192,12117,ITC,ITC4,3,Lombardia
2021-03-05 00:00:00,MAR,6050,2759,3291,1127,807,143,2373,798,802,4583,1467,ITI,ITI3,11,Marche
2021-02-12 00:00:00,PAB,721,214,507,316,292,104,7,2,0,475,246,ITH,ITH1,4,Provincia Autonoma Bolzano / Bozen
2021-02-20 00:00:00,SAR,2037,854,1183,483,157,195,1201,0,1,1703,334,ITG,ITG2,20,Sardegna
2021-01-20 00:00:00,PAT,288,71,217,229,11,48,0,0,0,276,12,ITH,ITH2,4,Provincia Autonoma Trento
2021-02-22 00:00:00,VEN,6957,3015,3942,743,232,339,5402,1,240,6570,387,ITH,ITH3,5,Veneto
2021-01-22 00:00:00,MAR,487,167,320,315,85,87,0,0,0,194,293,ITI,ITI3,11,Marche
2021-01-27 00:00:00,PAB,84,28,56,54,30,0,0,0,0,1,83,ITH,ITH1,4,Provincia Autonoma Bolzano / Bozen
2021-03-03 00:00:00,MAR,6690,3033,3657,818,818,254,3132,885,783,5809,881,ITI,ITI3,11,Marche
2021-03-09 00:00:00,PAB,1185,540,645,29,101,21,915,72,47,1183,2,ITH,ITH1,4,Provincia Autonoma Bolzano / Bozen
2021-02-12 00:00:00,LIG,1906,681,1225,863,221,391,430,0,1,987,919,ITC,ITC3,7,Liguria
2021-02-05 00:00:00,LOM,24949,7247,17702,14097,6218,4375,258,1,0,2131,22818,ITC,ITC4,3,Lombardia
2021-02-26 00:00:00,LIG,3645,1474,2171,762,202,168,2511,0,2,3317,328,ITC,ITC3,7,Liguria
2021-02-15 00:00:00,SAR,958,349,609,440,239,279,0,0,0,927,31,ITG,ITG2,20,Sardegna
2021-01-02 00:00:00,PAT,498,142,356,334,25,139,0,0,0,498,0,ITH,ITH2,4,Provincia Autonoma Trento
2021-03-13 00:00:00,PIE,12762,4618,8144,1168,1013,157,8299,0,2125,11331,1431,ITC,ITC1,1,Piemonte
2021-03-11 00:00:00,PUG,13945,6005,7940,2860,1176,478,4961,797,3673,10912,3033,ITF,ITF4,16,Puglia
2021-02-21 00:00:00,TOS,5104,2089,3015,3666,1219,195,2,13,9,4935,169,ITI,ITI1,9,Toscana
2021-03-04 00:00:00,UMB,4475,1849,2626,849,238,4,1552,366,1466,3647,828,ITI,ITI2,10,Umbria
2021-03-02 00:00:00,PIE,11128,4471,6657,902,1130,214,6381,0,2501,10313,815,ITC,ITC1,1,Piemonte
2021-02-10 00:00:00,CAL,2463,1074,1389,1469,637,357,0,0,0,839,1624,ITF,ITF6,18,Calabria
2021-02-13 00:00:00,UMB,115,28,87,68,46,0,1,0,0,112,3,ITI,ITI2,10,Umbria
2021-01-11 00:00:00,PAT,724,220,504,516,58,150,0,0,0,724,0,ITH,ITH2,4,Provincia Autonoma Trento
2021-01-12 00:00:00,MOL,336,114,222,132,75,129,0,0,0,336,0,ITF,ITF2,14,Molise
2021-03-03 00:00:00,VDA,255,118,137,9,111,1,129,1,4,186,69,ITC,ITC2,2,Valle d'Aosta / Vall√©e d'Aoste
2021-03-07 00:00:00,ABR,2523,630,1893,28,210,0,461,1,1823,2523,0,ITF,ITF1,13,Abruzzo
2021-02-21 00:00:00,PAT,155,92,63,154,0,0,0,0,1,43,112,ITH,ITH2,4,Provincia Autonoma Trento
2021-01-12 00:00:00,BAS,217,88,129,87,31,99,0,0,0,217,0,ITF,ITF5,17,Basilicata
2020-12-31 00:00:00,VDA,18,4,14,16,2,0,0,0,0,18,0,ITC,ITC2,2,Valle d'Aosta / Vall√©e d'Aoste
2021-03-09 00:00:00,LOM,31861,12183,19678,6018,4867,2253,11895,1426,5402,24563,7298,ITC,ITC4,3,Lombardia
2021-01-16 00:00:00,MAR,2006,723,1283,1059,662,285,0,0,0,2006,0,ITI,ITI3,11,Marche
2021-03-04 00:00:00,LIG,4719,2112,2607,918,318,277,2920,282,4,3889,830,ITC,ITC3,7,Liguria
2021-02-12 00:00:00,LOM,13337,4174,9163,7925,2629,2675,100,5,3,8681,4656,ITC,ITC4,3,Lombardia
2021-01-25 00:00:00,LOM,7020,2370,4650,5629,1159,218,14,0,0,486,6534,ITC,ITC4,3,Lombardia
2021-01-02 00:00:00,CAM,3674,1963,1711,3167,507,0,0,0,0,3674,0,ITF,ITF3,15,Campania
2021-01-30 00:00:00,PAB,496,244,252,216,179,101,0,0,0,4,492,ITH,ITH1,4,Provincia Autonoma Bolzano / Bozen
2021-01-07 00:00:00,EMR,10208,3381,6827,8181,959,1068,0,0,0,10208,0,ITH,ITH5,8,Emilia-Romagna
2021-01-16 00:00:00,PAT,318,147,171,303,1,14,0,0,0,318,0,ITH,ITH2,4,Provincia Autonoma Trento
2021-02-14 00:00:00,CAL,371,145,226,146,142,83,0,0,0,341,30,ITF,ITF6,18,Calabria
2021-02-14 00:00:00,LIG,233,122,111,31,30,112,60,0,0,233,0,ITC,ITC3,7,Liguria
2021-01-24 00:00:00,UMB,254,104,150,254,0,0,0,0,0,1,253,ITI,ITI2,10,Umbria
2021-01-27 00:00:00,LOM,8028,2675,5353,6192,1399,434,1,0,2,820,7208,ITC,ITC4,3,Lombardia
2021-01-20 00:00:00,CAM,1257,650,607,395,761,101,0,0,0,1257,0,ITF,ITF3,15,Campania
2021-02-22 00:00:00,PAT,745,259,486,118,11,70,501,0,45,660,85,ITH,ITH2,4,Provincia Autonoma Trento
2021-01-30 00:00:00,UMB,1577,483,1094,841,18,717,1,0,0,44,1533,ITI,ITI2,10,Umbria
2021-01-21 00:00:00,SAR,126,60,66,60,66,0,0,0,0,94,32,ITG,ITG2,20,Sardegna
2021-02-06 00:00:00,LOM,14968,5443,9525,9686,3368,1839,71,1,3,942,14026,ITC,ITC4,3,Lombardia
2021-01-09 00:00:00,FVG,2518,841,1677,1519,406,593,0,0,0,2518,0,ITH,ITH4,6,Friuli-Venezia Giulia
2021-02-18 00:00:00,PAT,1196,422,774,300,30,35,773,3,55,1138,58,ITH,ITH2,4,Provincia Autonoma Trento
2021-03-08 00:00:00,VDA,481,231,250,28,81,13,343,15,1,237,244,ITC,ITC2,2,Valle d'Aosta / Vall√©e d'Aoste
2021-02-23 00:00:00,EMR,8188,3211,4977,407,316,111,7353,0,1,7804,384,ITH,ITH5,8,Emilia-Romagna
2021-01-29 00:00:00,TOS,6136,1698,4438,5375,139,622,0,0,0,302,5834,ITI,ITI1,9,Toscana
2021-01-10 00:00:00,ABR,1139,409,730,1091,48,0,0,0,0,1139,0,ITF,ITF1,13,Abruzzo
2021-03-09 00:00:00,CAM,13859,6628,7231,744,4620,217,3729,1118,3431,10078,3781,ITF,ITF3,15,Campania
2021-01-27 00:00:00,CAM,7737,3820,3917,5837,1630,270,0,0,0,162,7575,ITF,ITF3,15,Campania
2021-03-16 00:00:00,FVG,3061,1262,1799,324,339,196,2202,0,0,1024,2037,ITH,ITH4,6,Friuli-Venezia Giulia
2021-01-15 00:00:00,LAZ,6223,2465,3758,4476,604,988,155,0,0,6223,0,ITI,ITI4,12,Lazio
2021-02-20 00:00:00,ABR,4781,1842,2939,310,569,192,1417,406,1887,4705,76,ITF,ITF1,13,Abruzzo
2021-02-11 00:00:00,MOL,293,133,160,225,19,45,0,3,1,257,36,ITF,ITF2,14,Molise
2021-03-12 00:00:00,MAR,4710,2014,2696,820,727,0,1904,330,929,3465,1245,ITI,ITI3,11,Marche
2021-02-12 00:00:00,VEN,4325,1453,2872,2761,881,671,6,2,4,3753,572,ITH,ITH3,5,Veneto
2021-01-08 00:00:00,CAL,2109,1014,1095,1898,211,0,0,0,0,2109,0,ITF,ITF6,18,Calabria
2021-03-09 00:00:00,LIG,5734,2663,3071,1027,621,131,3422,533,0,4311,1423,ITC,ITC3,7,Liguria
2021-01-26 00:00:00,LIG,2480,802,1678,1963,261,251,0,0,5,104,2376,ITC,ITC3,7,Liguria
2021-01-25 00:00:00,VEN,6466,2074,4392,5060,499,904,1,0,2,170,6296,ITH,ITH3,5,Veneto
2021-01-12 00:00:00,PIE,10040,3401,6639,6859,2009,1172,0,0,0,10040,0,ITC,ITC1,1,Piemonte
2021-02-18 00:00:00,PUG,4368,1843,2525,2710,966,683,5,2,2,3765,603,ITF,ITF4,16,Puglia
2021-01-07 00:00:00,VDA,275,111,164,224,46,5,0,0,0,275,0,ITC,ITC2,2,Valle d'Aosta / Vall√©e d'Aoste
2021-02-04 00:00:00,MOL,758,295,463,502,114,141,0,0,1,77,681,ITF,ITF2,14,Molise
2021-03-15 00:00:00,BAS,2324,973,1351,78,45,0,1912,23,266,518,1806,ITF,ITF5,17,Basilicata
2021-03-18 00:00:00,EMR,12844,5438,7406,438,1988,19,10349,1,49,5335,7509,ITH,ITH5,8,Emilia-Romagna
2021-01-10 00:00:00,PIE,5207,2273,2934,3904,784,519,0,0,0,5207,0,ITC,ITC1,1,Piemonte
2021-02-09 00:00:00,FVG,1848,556,1292,1053,509,286,0,0,0,1559,289,ITH,ITH4,6,Friuli-Venezia Giulia
2021-01-06 00:00:00,SIC,6471,3402,3069,5717,752,2,0,0,0,6471,0,ITG,ITG1,19,Sicilia
2021-01-27 00:00:00,LIG,1743,603,1140,1336,179,227,0,0,1,142,1601,ITC,ITC3,7,Liguria
2021-02-21 00:00:00,LAZ,6776,3094,3682,1245,362,51,4495,607,16,6494,282,ITI,ITI4,12,Lazio
2021-03-01 00:00:00,SIC,12973,6129,6844,1557,1809,392,4302,1763,3150,11314,1659,ITG,ITG1,19,Sicilia
2021-01-26 00:00:00,CAL,1805,861,944,1571,164,70,0,0,0,285,1520,ITF,ITF6,18,Calabria
2021-03-14 00:00:00,ABR,1883,731,1152,8,150,0,1476,0,249,1216,667,ITF,ITF1,13,Abruzzo
2021-02-09 00:00:00,VDA,251,84,167,78,30,14,75,1,53,68,183,ITC,ITC2,2,Valle d'Aosta / Vall√©e d'Aoste
2021-02-01 00:00:00,MOL,562,201,361,301,149,111,0,0,1,14,548,ITF,ITF2,14,Molise
2021-02-26 00:00:00,VDA,206,57,149,67,34,4,96,4,1,122,84,ITC,ITC2,2,Valle d'Aosta / Vall√©e d'Aoste
2021-01-15 00:00:00,PIE,8961,2951,6010,5493,1924,1544,0,0,0,8961,0,ITC,ITC1,1,Piemonte
2021-01-21 00:00:00,LIG,1102,385,717,584,185,332,1,0,0,672,430,ITC,ITC3,7,Liguria
2021-02-24 00:00:00,SIC,9599,4869,4730,1422,1253,499,4028,1474,923,9004,595,ITG,ITG1,19,Sicilia
2021-02-05 00:00:00,CAM,7261,3463,3798,3447,3497,308,9,0,0,2133,5128,ITF,ITF3,15,Campania
2021-01-25 00:00:00,MAR,1596,559,1037,1426,114,56,0,0,0,97,1499,ITI,ITI3,11,Marche
2021-02-07 00:00:00,FVG,1561,483,1078,866,693,2,0,0,0,386,1175,ITH,ITH4,6,Friuli-Venezia Giulia
2021-01-26 00:00:00,LOM,8325,2704,5621,6640,1440,223,22,0,0,334,7991,ITC,ITC4,3,Lombardia
2021-02-06 00:00:00,VEN,4089,1351,2738,3022,697,367,3,0,0,709,3380,ITH,ITH3,5,Veneto
2021-01-07 00:00:00,MAR,1802,633,1169,1480,322,0,0,0,0,1802,0,ITI,ITI3,11,Marche
2021-03-07 00:00:00,SAR,1590,724,866,307,238,32,1011,0,2,1117,473,ITG,ITG2,20,Sardegna
2021-03-15 00:00:00,CAL,3441,1648,1793,542,921,136,1093,163,586,2016,1425,ITF,ITF6,18,Calabria
2021-03-05 00:00:00,LAZ,18480,7797,10683,2723,1745,256,8464,1323,3969,13760,4720,ITI,ITI4,12,Lazio
2021-01-05 00:00:00,CAM,7237,3638,3599,5810,1321,106,0,0,0,7237,0,ITF,ITF3,15,Campania
2021-01-19 00:00:00,ABR,111,55,56,27,34,50,0,0,0,91,20,ITF,ITF1,13,Abruzzo
2021-03-07 00:00:00,PAB,114,13,101,59,51,0,3,0,1,9,105,ITH,ITH1,4,Provincia Autonoma Bolzano / Bozen
2021-02-25 00:00:00,PIE,12177,5226,6951,1436,2058,405,6320,0,1958,11629,548,ITC,ITC1,1,Piemonte
2021-03-11 00:00:00,BAS,1783,919,864,163,162,77,905,253,223,824,959,ITF,ITF5,17,Basilicata
2021-02-13 00:00:00,SIC,3106,1167,1939,1295,1241,570,0,0,0,2849,257,ITG,ITG1,19,Sicilia
2021-01-14 00:00:00,CAL,2557,1214,1343,1962,592,3,0,0,0,2557,0,ITF,ITF6,18,Calabria
2021-03-09 00:00:00,SIC,13001,5465,7536,1592,2291,584,3943,937,3654,10629,2372,ITG,ITG1,19,Sicilia
2021-02-28 00:00:00,PUG,5725,1757,3968,559,258,25,1483,194,3206,5539,186,ITF,ITF4,16,Puglia
2020-12-30 00:00:00,FVG,630,246,384,601,29,0,0,0,0,630,0,ITH,ITH4,6,Friuli-Venezia Giulia
2021-03-02 00:00:00,SAR,2738,1415,1323,1044,730,260,319,383,2,1705,1033,ITG,ITG2,20,Sardegna
2021-02-13 00:00:00,EMR,3603,1077,2526,2779,493,145,186,0,0,3005,598,ITH,ITH5,8,Emilia-Romagna
2021-01-17 00:00:00,MOL,78,38,40,78,0,0,0,0,0,48,30,ITF,ITF2,14,Molise
2021-01-28 00:00:00,PIE,5588,1809,3779,4118,879,590,1,0,0,384,5204,ITC,ITC1,1,Piemonte
2021-01-25 00:00:00,SIC,7511,3696,3815,6633,808,70,0,0,0,322,7189,ITG,ITG1,19,Sicilia
2021-01-11 00:00:00,PIE,8740,2980,5760,6053,1561,1126,0,0,0,8740,0,ITC,ITC1,1,Piemonte
2021-03-07 00:00:00,LOM,10792,4751,6041,2998,1994,73,4520,552,655,8240,2552,ITC,ITC4,3,Lombardia
2021-03-17 00:00:00,VDA,420,183,237,33,98,14,229,40,6,261,159,ITC,ITC2,2,Valle d'Aosta / Vall√©e d'Aoste
2021-01-30 00:00:00,CAM,10721,5079,5642,6930,3564,227,0,0,0,39,10682,ITF,ITF3,15,Campania
2021-02-11 00:00:00,SAR,1314,490,824,588,356,369,1,0,0,1203,111,ITG,ITG2,20,Sardegna
2021-01-11 00:00:00,BAS,183,66,117,107,35,41,0,0,0,183,0,ITF,ITF5,17,Basilicata
2021-02-04 00:00:00,LAZ,6045,2281,3764,4460,621,892,72,0,0,942,5103,ITI,ITI4,12,Lazio
2021-02-02 00:00:00,PIE,10232,3504,6728,6866,2048,1318,0,0,0,814,9418,ITC,ITC1,1,Piemonte
2021-01-28 00:00:00,BAS,903,401,502,717,104,81,1,0,0,119,784,ITF,ITF5,17,Basilicata
2021-01-22 00:00:00,LAZ,3662,1442,2220,3379,90,70,123,0,0,148,3514,ITI,ITI4,12,Lazio
2021-02-20 00:00:00,LIG,1334,636,698,159,464,122,589,0,0,1333,1,ITC,ITC3,7,Liguria
2021-02-15 00:00:00,UMB,1368,692,676,10,8,0,1350,0,0,1367,1,ITI,ITI2,10,Umbria
2021-01-07 00:00:00,TOS,6018,1751,4267,5308,30,680,0,0,0,6018,0,ITI,ITI1,9,Toscana
2021-02-06 00:00:00,PAT,572,296,276,178,7,0,387,0,0,432,140,ITH,ITH2,4,Provincia Autonoma Trento
2021-01-18 00:00:00,PAB,1655,638,1017,368,299,7,981,0,0,1651,4,ITH,ITH1,4,Provincia Autonoma Bolzano / Bozen
2021-01-19 00:00:00,FVG,7,2,5,5,0,2,0,0,0,7,0,ITH,ITH4,6,Friuli-Venezia Giulia
2021-02-23 00:00:00,VDA,216,123,93,0,165,0,0,35,16,216,0,ITC,ITC2,2,Valle d'Aosta / Vall√©e d'Aoste
2020-12-28 00:00:00,LOM,103,44,59,102,1,0,0,0,0,103,0,ITC,ITC4,3,Lombardia
2021-02-09 00:00:00,EMR,4150,1246,2904,2217,467,1198,268,0,0,2305,1845,ITH,ITH5,8,Emilia-Romagna
2021-01-06 00:00:00,SAR,1615,549,1066,1510,105,0,0,0,0,1615,0,ITG,ITG2,20,Sardegna
2021-02-25 00:00:00,SAR,2899,1255,1644,1474,738,466,161,51,9,2293,606,ITG,ITG2,20,Sardegna
2021-01-03 00:00:00,LIG,734,230,504,658,75,0,0,0,1,734,0,ITC,ITC3,7,Liguria
2021-02-19 00:00:00,UMB,743,293,450,281,16,14,432,0,0,526,217,ITI,ITI2,10,Umbria
2021-01-18 00:00:00,LAZ,5835,2268,3567,3901,756,725,453,0,0,4857,978,ITI,ITI4,12,Lazio
2021-02-16 00:00:00,ABR,1978,869,1109,841,513,139,410,75,0,1966,12,ITF,ITF1,13,Abruzzo
2021-02-23 00:00:00,FVG,2615,1252,1363,105,106,206,1943,254,1,2437,178,ITH,ITH4,6,Friuli-Venezia Giulia
2021-01-18 00:00:00,TOS,1119,636,483,430,314,375,0,0,0,1021,98,ITI,ITI1,9,Toscana
2021-02-26 00:00:00,LOM,17849,7385,10464,3080,1910,1130,10402,1303,24,16238,1611,ITC,ITC4,3,Lombardia
2021-02-26 00:00:00,FVG,3716,2087,1629,75,140,433,1737,1032,299,3570,146,ITH,ITH4,6,Friuli-Venezia Giulia
2021-02-08 00:00:00,PUG,3959,1593,2366,2932,611,389,1,25,1,1570,2389,ITF,ITF4,16,Puglia
2021-02-22 00:00:00,TOS,9817,4253,5564,3484,2279,315,22,1014,2703,9539,278,ITI,ITI1,9,Toscana
2021-02-14 00:00:00,EMR,1398,377,1021,858,482,39,19,0,0,1278,120,ITH,ITH5,8,Emilia-Romagna
2021-01-11 00:00:00,MAR,1176,411,765,1021,155,0,0,0,0,1176,0,ITI,ITI3,11,Marche
2021-03-12 00:00:00,PIE,13719,5073,8646,2131,1330,454,7549,0,2255,10810,2909,ITC,ITC1,1,Piemonte
2021-01-20 00:00:00,SIC,808,410,398,422,194,192,0,0,0,573,235,ITG,ITG1,19,Sicilia
2021-01-27 00:00:00,TOS,4835,1572,3263,4019,74,742,0,0,0,207,4628,ITI,ITI1,9,Toscana
2021-01-25 00:00:00,PAT,774,205,569,482,30,262,0,0,0,23,751,ITH,ITH2,4,Provincia Autonoma Trento
2021-02-10 00:00:00,TOS,4262,1280,2982,3536,241,484,0,1,0,3739,523,ITI,ITI1,9,Toscana
2021-03-05 00:00:00,LOM,27838,11465,16373,6991,6545,1466,10531,1900,405,19709,8129,ITC,ITC4,3,Lombardia
2021-02-03 00:00:00,LIG,2241,771,1470,1601,257,382,0,0,1,54,2187,ITC,ITC3,7,Liguria
2021-02-21 00:00:00,EMR,4404,1693,2711,394,267,190,3553,0,0,3967,437,ITH,ITH5,8,Emilia-Romagna
2021-01-16 00:00:00,PAB,2748,1229,1519,449,360,77,1861,0,1,2748,0,ITH,ITH1,4,Provincia Autonoma Bolzano / Bozen
2021-03-10 00:00:00,PIE,13359,5052,8307,1660,1364,279,7915,0,2141,11066,2293,ITC,ITC1,1,Piemonte
2021-02-19 00:00:00,VEN,7292,3121,4171,1535,716,664,4368,3,6,7090,202,ITH,ITH3,5,Veneto
2021-01-07 00:00:00,CAL,2180,1061,1119,1883,297,0,0,0,0,2180,0,ITF,ITF6,18,Calabria
2021-02-28 00:00:00,EMR,6809,2521,4288,1769,460,53,4219,4,304,4966,1843,ITH,ITH5,8,Emilia-Romagna
2021-01-22 00:00:00,CAM,1523,775,748,970,344,209,0,0,0,673,850,ITF,ITF3,15,Campania
2021-02-12 00:00:00,CAM,6555,2876,3679,1812,1467,214,3058,0,4,6343,212,ITF,ITF3,15,Campania
2021-03-18 00:00:00,FVG,2916,1246,1670,41,178,0,2696,0,1,1470,1446,ITH,ITH4,6,Friuli-Venezia Giulia
2021-02-22 00:00:00,PUG,9559,4503,5056,1406,724,139,6757,215,318,9229,330,ITF,ITF4,16,Puglia
2021-03-05 00:00:00,FVG,3617,1426,2191,1043,686,33,1668,43,144,2583,1034,ITH,ITH4,6,Friuli-Venezia Giulia
2021-01-06 00:00:00,VEN,8129,2382,5747,6307,1003,807,1,2,9,8129,0,ITH,ITH3,5,Veneto
2021-02-23 00:00:00,CAL,1549,728,821,437,381,206,522,2,1,1434,115,ITF,ITF6,18,Calabria
2021-02-05 00:00:00,LIG,2628,975,1653,1728,432,464,0,0,4,301,2327,ITC,ITC3,7,Liguria
2021-02-08 00:00:00,PAT,1149,318,831,550,59,237,302,0,1,341,808,ITH,ITH2,4,Provincia Autonoma Trento
2020-12-29 00:00:00,LOM,100,43,57,100,0,0,0,0,0,100,0,ITC,ITC4,3,Lombardia
2021-01-30 00:00:00,MAR,1908,669,1239,1566,342,0,0,0,0,29,1879,ITI,ITI3,11,Marche
2021-02-18 00:00:00,BAS,1070,401,669,270,74,150,576,0,0,855,215,ITF,ITF5,17,Basilicata
2021-01-19 00:00:00,MOL,173,63,110,90,59,22,0,0,2,162,11,ITF,ITF2,14,Molise
2020-12-29 00:00:00,SAR,57,32,25,56,1,0,0,0,0,57,0,ITG,ITG2,20,Sardegna
2021-02-26 00:00:00,CAM,13329,4230,9099,623,2381,223,3222,1,6879,11994,1335,ITF,ITF3,15,Campania
2021-02-27 00:00:00,EMR,10941,3987,6954,1719,499,114,7671,0,938,9210,1731,ITH,ITH5,8,Emilia-Romagna
2021-02-10 00:00:00,VDA,248,77,171,51,25,26,127,1,18,141,107,ITC,ITC2,2,Valle d'Aosta / Vall√©e d'Aoste
2021-02-18 00:00:00,PAB,1641,401,1240,23,313,20,4,0,1281,1638,3,ITH,ITH1,4,Provincia Autonoma Bolzano / Bozen
2021-01-07 00:00:00,LOM,11557,3594,7963,8956,1925,652,22,1,1,11557,0,ITC,ITC4,3,Lombardia
2021-01-25 00:00:00,ABR,1604,633,971,1584,20,0,0,0,0,20,1584,ITF,ITF1,13,Abruzzo
2021-02-27 00:00:00,SAR,1917,644,1273,1059,379,304,175,0,0,1362,555,ITG,ITG2,20,Sardegna
2021-02-05 00:00:00,LAZ,6910,2722,4188,5095,631,995,189,0,0,1131,5779,ITI,ITI4,12,Lazio
2021-02-11 00:00:00,TOS,5383,2021,3362,2809,2218,323,12,10,11,5141,242,ITI,ITI1,9,Toscana
2021-01-07 00:00:00,CAM,8910,4166,4744,6313,2265,332,0,0,0,8910,0,ITF,ITF3,15,Campania
2021-01-08 00:00:00,PAB,1488,469,1019,777,449,166,96,0,0,1488,0,ITH,ITH1,4,Provincia Autonoma Bolzano / Bozen
2020-12-31 00:00:00,PAB,846,485,361,423,423,0,0,0,0,846,0,ITH,ITH1,4,Provincia Autonoma Bolzano / Bozen
2021-02-02 00:00:00,TOS,3741,1475,2266,3020,287,422,6,6,0,194,3547,ITI,ITI1,9,Toscana
2021-02-11 00:00:00,PUG,3693,1401,2292,2568,400,723,0,0,2,2417,1276,ITF,ITF4,16,Puglia
2021-01-25 00:00:00,PUG,3820,1676,2144,3470,179,168,2,0,1,423,3397,ITF,ITF4,16,Puglia
2021-02-19 00:00:00,PAB,1962,449,1513,121,250,79,7,0,1505,1951,11,ITH,ITH1,4,Provincia Autonoma Bolzano / Bozen
2021-02-07 00:00:00,MAR,1871,735,1136,1156,669,46,0,0,0,344,1527,ITI,ITI3,11,Marche
2021-03-03 00:00:00,PIE,12044,4606,7438,1101,1016,258,7015,0,2654,11221,823,ITC,ITC1,1,Piemonte
2021-02-20 00:00:00,CAL,1358,735,623,438,411,55,433,19,2,1043,315,ITF,ITF6,18,Calabria
2021-02-04 00:00:00,SAR,2271,816,1455,1737,363,170,1,0,0,916,1355,ITG,ITG2,20,Sardegna
2021-01-09 00:00:00,EMR,9874,3425,6449,7824,1169,881,0,0,0,9874,0,ITH,ITH5,8,Emilia-Romagna
2021-02-23 00:00:00,UMB,1693,658,1035,1187,95,17,394,0,0,1651,42,ITI,ITI2,10,Umbria
2021-02-27 00:00:00,ABR,2809,1337,1472,253,185,123,732,642,874,2543,266,ITF,ITF1,13,Abruzzo
2021-02-01 00:00:00,CAL,2497,1192,1305,2044,410,43,0,0,0,248,2249,ITF,ITF6,18,Calabria
2021-03-17 00:00:00,BAS,1449,606,843,22,29,0,1391,5,2,27,1422,ITF,ITF5,17,Basilicata
2021-01-19 00:00:00,SIC,1271,521,750,521,512,238,0,0,0,1093,178,ITG,ITG1,19,Sicilia
2021-01-08 00:00:00,EMR,10808,3555,7253,8454,1274,1080,0,0,0,10808,0,ITH,ITH5,8,Emilia-Romagna
2021-02-18 00:00:00,VEN,5700,2440,3260,934,353,607,3799,1,6,5637,63,ITH,ITH3,5,Veneto
2021-02-24 00:00:00,EMR,9270,3542,5728,639,582,220,7766,0,63,8411,859,ITH,ITH5,8,Emilia-Romagna
2021-01-06 00:00:00,MOL,689,260,429,456,62,171,0,0,0,689,0,ITF,ITF2,14,Molise
2021-01-01 00:00:00,PIE,1038,395,643,922,116,0,0,0,0,1038,0,ITC,ITC1,1,Piemonte
2021-01-17 00:00:00,FVG,1720,524,1196,674,560,486,0,0,0,1720,0,ITH,ITH4,6,Friuli-Venezia Giulia
2021-03-09 00:00:00,PUG,12415,5468,6947,1763,857,197,5233,1007,3358,10430,1985,ITF,ITF4,16,Puglia
2021-03-03 00:00:00,MOL,672,316,356,63,389,48,0,45,127,590,82,ITF,ITF2,14,Molise
2020-12-31 00:00:00,UMB,322,127,195,310,12,0,0,0,0,322,0,ITI,ITI2,10,Umbria
2021-01-16 00:00:00,MOL,420,166,254,270,23,127,0,0,0,420,0,ITF,ITF2,14,Molise
2021-01-17 00:00:00,VDA,131,56,75,49,3,20,59,0,0,131,0,ITC,ITC2,2,Valle d'Aosta / Vall√©e d'Aoste
2021-02-21 00:00:00,LIG,869,491,378,183,317,102,267,0,0,865,4,ITC,ITC3,7,Liguria
2021-02-08 00:00:00,BAS,557,193,364,436,72,49,0,0,0,151,406,ITF,ITF5,17,Basilicata
2021-03-07 00:00:00,LIG,1858,1085,773,184,524,258,508,383,1,1557,301,ITC,ITC3,7,Liguria
2021-02-16 00:00:00,FVG,2516,1135,1381,260,275,221,1760,0,0,2400,116,ITH,ITH4,6,Friuli-Venezia Giulia
2021-01-26 00:00:00,ABR,1542,567,975,1513,29,0,0,0,0,29,1513,ITF,ITF1,13,Abruzzo
2021-01-18 00:00:00,SAR,904,326,578,714,190,0,0,0,0,780,124,ITG,ITG2,20,Sardegna
2021-03-11 00:00:00,EMR,16831,6890,9941,1119,1720,212,8800,1215,3765,11009,5822,ITH,ITH5,8,Emilia-Romagna
2021-01-17 00:00:00,VEN,1932,780,1152,1587,220,120,3,0,2,1583,349,ITH,ITH3,5,Veneto
2021-01-12 00:00:00,TOS,3581,1398,2183,2944,283,354,0,0,0,3581,0,ITI,ITI1,9,Toscana
2021-02-03 00:00:00,VDA,351,114,237,157,141,52,1,0,0,14,337,ITC,ITC2,2,Valle d'Aosta / Vall√©e d'Aoste
2021-03-09 00:00:00,VDA,204,96,108,2,79,23,36,39,25,172,32,ITC,ITC2,2,Valle d'Aosta / Vall√©e d'Aoste
2021-01-17 00:00:00,PAT,251,195,56,251,0,0,0,0,0,251,0,ITH,ITH2,4,Provincia Autonoma Trento
2021-01-01 00:00:00,TOS,2368,786,1582,1716,2,650,0,0,0,2368,0,ITI,ITI1,9,Toscana
2021-01-26 00:00:00,VDA,139,48,91,115,12,12,0,0,0,0,139,ITC,ITC2,2,Valle d'Aosta / Vall√©e d'Aoste
2020-12-31 00:00:00,SAR,32,16,16,28,4,0,0,0,0,32,0,ITG,ITG2,20,Sardegna
2021-01-11 00:00:00,MOL,557,194,363,196,250,111,0,0,0,557,0,ITF,ITF2,14,Molise
2020-12-27 00:00:00,PAB,143,65,78,136,6,0,1,0,0,143,0,ITH,ITH1,4,Provincia Autonoma Bolzano / Bozen
2021-01-26 00:00:00,CAM,7297,3701,3596,5742,1333,222,0,0,0,352,6945,ITF,ITF3,15,Campania
2021-02-21 00:00:00,FVG,799,280,519,213,177,25,383,1,0,422,377,ITH,ITH4,6,Friuli-Venezia Giulia
2021-01-06 00:00:00,PAT,42,13,29,42,0,0,0,0,0,42,0,ITH,ITH2,4,Provincia Autonoma Trento
2021-01-20 00:00:00,VDA,23,8,15,0,0,6,17,0,0,23,0,ITC,ITC2,2,Valle d'Aosta / Vall√©e d'Aoste
2021-01-23 00:00:00,TOS,3949,1354,2595,2936,172,841,0,0,0,640,3309,ITI,ITI1,9,Toscana
2021-01-19 00:00:00,MAR,225,81,144,120,20,85,0,0,0,141,84,ITI,ITI3,11,Marche
2021-01-07 00:00:00,BAS,640,319,321,556,55,29,0,0,0,640,0,ITF,ITF5,17,Basilicata
2021-03-10 00:00:00,PAB,1172,446,726,653,188,0,134,80,117,1029,143,ITH,ITH1,4,Provincia Autonoma Bolzano / Bozen
2021-02-18 00:00:00,MOL,319,74,245,296,23,0,0,0,0,306,13,ITF,ITF2,14,Molise
2021-01-06 00:00:00,LIG,1660,616,1044,1230,250,113,64,0,3,1660,0,ITC,ITC3,7,Liguria
2021-01-02 00:00:00,SIC,4872,2533,2339,4311,561,0,0,0,0,4872,0,ITG,ITG1,19,Sicilia
2021-01-10 00:00:00,LIG,648,262,386,369,103,176,0,0,0,648,0,ITC,ITC3,7,Liguria
2021-02-13 00:00:00,PUG,3718,1450,2268,2879,519,291,4,18,7,3026,692,ITF,ITF4,16,Puglia
2021-03-03 00:00:00,VEN,11863,4496,7367,3310,1499,1110,3375,310,2259,8399,3464,ITH,ITH3,5,Veneto
2021-02-17 00:00:00,UMB,1618,748,870,363,14,0,1240,0,1,1267,351,ITI,ITI2,10,Umbria
2021-02-14 00:00:00,SIC,1057,402,655,433,388,236,0,0,0,917,140,ITG,ITG1,19,Sicilia
2021-02-01 00:00:00,FVG,2093,687,1406,1587,371,135,0,0,0,14,2079,ITH,ITH4,6,Friuli-Venezia Giulia
2021-03-11 00:00:00,MAR,6829,2929,3900,1094,921,38,3227,401,1148,5458,1371,ITI,ITI3,11,Marche
2021-02-23 00:00:00,BAS,1900,771,1129,159,49,35,1657,0,0,1762,138,ITF,ITF5,17,Basilicata
2021-01-22 00:00:00,CAL,656,274,382,298,248,110,0,0,0,654,2,ITF,ITF6,18,Calabria
2021-02-05 00:00:00,VDA,294,102,192,159,82,0,53,0,0,101,193,ITC,ITC2,2,Valle d'Aosta / Vall√©e d'Aoste
2021-01-14 00:00:00,TOS,3254,1179,2075,2459,475,320,0,0,0,3254,0,ITI,ITI1,9,Toscana
2021-03-18 00:00:00,ABR,3896,1651,2245,281,286,3,3297,22,7,2065,1831,ITF,ITF1,13,Abruzzo
2021-01-26 00:00:00,MOL,450,184,266,444,5,0,0,0,1,8,442,ITF,ITF2,14,Molise
2021-01-18 00:00:00,FVG,1960,607,1353,1358,492,110,0,0,0,1866,94,ITH,ITH4,6,Friuli-Venezia Giulia
2021-02-26 00:00:00,BAS,2134,895,1239,88,104,1,1941,0,0,2055,79,ITF,ITF5,17,Basilicata
2021-03-13 00:00:00,VDA,142,84,58,2,114,0,0,23,3,142,0,ITC,ITC2,2,Valle d'Aosta / Vall√©e d'Aoste
2021-01-04 00:00:00,VDA,142,59,83,126,16,0,0,0,0,142,0,ITC,ITC2,2,Valle d'Aosta / Vall√©e d'Aoste
2021-02-13 00:00:00,MOL,132,80,52,129,3,0,0,0,0,132,0,ITF,ITF2,14,Molise
2021-02-25 00:00:00,VDA,201,101,100,6,157,11,0,25,2,194,7,ITC,ITC2,2,Valle d'Aosta / Vall√©e d'Aoste
2021-01-22 00:00:00,LIG,1811,602,1209,1063,183,565,0,0,0,1326,485,ITC,ITC3,7,Liguria
2021-02-10 00:00:00,EMR,3935,1353,2582,2330,574,775,256,0,0,2735,1200,ITH,ITH5,8,Emilia-Romagna
2021-02-15 00:00:00,VEN,4386,1820,2566,483,210,383,3294,14,2,4146,240,ITH,ITH3,5,Veneto
2021-02-09 00:00:00,TOS,4486,1468,3018,3583,388,513,2,0,0,3875,611,ITI,ITI1,9,Toscana
2021-03-02 00:00:00,LOM,22385,9533,12852,3033,4188,2037,11219,1778,130,19460,2925,ITC,ITC4,3,Lombardia
2021-01-08 00:00:00,LAZ,7707,2887,4820,6517,392,798,0,0,0,7707,0,ITI,ITI4,12,Lazio
2021-03-13 00:00:00,VEN,16626,6858,9768,2069,5364,74,4812,280,4027,13714,2912,ITH,ITH3,5,Veneto
2021-01-26 00:00:00,PUG,5361,2398,2963,4847,281,232,1,0,0,574,4787,ITF,ITF4,16,Puglia
2021-03-16 00:00:00,TOS,4715,1808,2907,1543,1086,103,1955,12,16,2533,2182,ITI,ITI1,9,Toscana
2021-02-20 00:00:00,SIC,7261,3731,3530,839,1332,546,3749,620,175,7011,250,ITG,ITG1,19,Sicilia
2021-01-27 00:00:00,EMR,8316,2934,5382,6886,775,654,0,1,0,463,7853,ITH,ITH5,8,Emilia-Romagna
2021-01-02 00:00:00,PIE,3539,1134,2405,3072,414,53,0,0,0,3539,0,ITC,ITC1,1,Piemonte
2021-02-09 00:00:00,LAZ,8393,3484,4909,3258,582,548,4005,0,0,4571,3822,ITI,ITI4,12,Lazio
2021-03-07 00:00:00,CAM,11911,5344,6567,513,4258,85,3276,1512,2267,8070,3841,ITF,ITF3,15,Campania
2021-03-13 00:00:00,LOM,25094,8949,16145,3715,2926,250,10001,612,7590,19121,5973,ITC,ITC4,3,Lombardia
2021-01-15 00:00:00,FVG,2028,606,1422,1283,370,375,0,0,0,2028,0,ITH,ITH4,6,Friuli-Venezia Giulia
2021-01-14 00:00:00,LOM,26254,7670,18584,14941,5732,5352,228,1,0,26254,0,ITC,ITC4,3,Lombardia
2021-03-10 00:00:00,SIC,13535,5773,7762,1477,2884,933,4060,646,3535,11145,2390,ITG,ITG1,19,Sicilia
2021-02-02 00:00:00,ABR,1798,677,1121,1243,413,142,0,0,0,241,1557,ITF,ITF1,13,Abruzzo
2021-01-12 00:00:00,UMB,784,247,537,665,14,105,0,0,0,784,0,ITI,ITI2,10,Umbria
2021-02-20 00:00:00,VEN,6321,1985,4336,1798,204,100,971,6,3242,6317,4,ITH,ITH3,5,Veneto
2021-03-17 00:00:00,TOS,10336,4129,6207,337,1076,115,8804,2,2,6214,4122,ITI,ITI1,9,Toscana
2021-02-17 00:00:00,MAR,1791,664,1127,968,522,300,1,0,0,1672,119,ITI,ITI3,11,Marche
2021-01-26 00:00:00,TOS,5392,1791,3601,4357,84,951,0,0,0,219,5173,ITI,ITI1,9,Toscana
2020-12-31 00:00:00,LAZ,5218,2095,3123,4927,12,279,0,0,0,5218,0,ITI,ITI4,12,Lazio
2021-03-09 00:00:00,EMR,14310,5759,8551,1024,928,180,7563,1072,3543,10376,3934,ITH,ITH5,8,Emilia-Romagna
2021-03-06 00:00:00,TOS,7096,2839,4257,3804,1614,145,30,357,1146,2905,4191,ITI,ITI1,9,Toscana
2021-01-01 00:00:00,UMB,269,102,167,268,1,0,0,0,0,269,0,ITI,ITI2,10,Umbria
2021-01-23 00:00:00,LOM,1114,357,757,644,332,138,0,0,0,916,198,ITC,ITC4,3,Lombardia
2021-01-15 00:00:00,CAL,2793,1258,1535,1690,691,412,0,0,0,2793,0,ITF,ITF6,18,Calabria
2021-03-18 00:00:00,LIG,4316,1863,2453,523,482,70,3235,2,4,1783,2533,ITC,ITC3,7,Liguria
2021-02-26 00:00:00,MAR,3569,1493,2076,446,231,330,2519,4,39,3093,476,ITI,ITI3,11,Marche
2021-03-05 00:00:00,LIG,4851,2142,2709,799,325,81,3329,312,5,3727,1124,ITC,ITC3,7,Liguria
2021-01-26 00:00:00,PAT,497,138,359,397,16,84,0,0,0,25,472,ITH,ITH2,4,Provincia Autonoma Trento
2020-12-31 00:00:00,TOS,805,202,603,97,10,698,0,0,0,805,0,ITI,ITI1,9,Toscana
2020-12-27 00:00:00,SIC,89,54,35,62,2,25,0,0,0,89,0,ITG,ITG1,19,Sicilia
2021-01-01 00:00:00,PAB,1,1,0,1,0,0,0,0,0,1,0,ITH,ITH1,4,Provincia Autonoma Bolzano / Bozen
2021-01-12 00:00:00,VEN,5230,1516,3714,2251,1056,1752,168,0,3,5230,0,ITH,ITH3,5,Veneto
2021-01-04 00:00:00,CAM,5826,2963,2863,4850,976,0,0,0,0,5826,0,ITF,ITF3,15,Campania
2021-02-14 00:00:00,PUG,784,348,436,681,32,70,0,0,1,662,122,ITF,ITF4,16,Puglia
2021-03-16 00:00:00,PAT,1350,496,854,221,81,36,1009,0,3,576,774,ITH,ITH2,4,Provincia Autonoma Trento
2021-01-12 00:00:00,PAB,1527,398,1129,299,680,475,73,0,0,1527,0,ITH,ITH1,4,Provincia Autonoma Bolzano / Bozen
2021-01-23 00:00:00,VEN,4063,1255,2808,3404,205,450,1,0,3,34,4029,ITH,ITH3,5,Veneto
2021-03-07 00:00:00,VEN,4446,1739,2707,1692,927,17,983,0,827,3891,555,ITH,ITH3,5,Veneto
2021-01-11 00:00:00,LOM,15977,5309,10668,11778,3455,699,42,1,2,15977,0,ITC,ITC4,3,Lombardia
2021-01-30 00:00:00,PIE,5978,2135,3843,4367,1116,495,0,0,0,218,5760,ITC,ITC1,1,Piemonte
2021-02-04 00:00:00,FVG,2731,807,1924,1723,543,465,0,0,0,36,2695,ITH,ITH4,6,Friuli-Venezia Giulia
2021-01-10 00:00:00,BAS,77,24,53,9,68,0,0,0,0,77,0,ITF,ITF5,17,Basilicata
2021-02-05 00:00:00,BAS,983,443,540,611,181,191,0,0,0,64,919,ITF,ITF5,17,Basilicata
2021-03-02 00:00:00,VEN,11318,4547,6771,2760,1847,1167,3285,411,1848,8043,3275,ITH,ITH3,5,Veneto
2021-02-25 00:00:00,PUG,11569,4941,6628,1674,871,419,5605,725,2275,10458,1111,ITF,ITF4,16,Puglia
2020-12-28 00:00:00,CAL,6,2,4,6,0,0,0,0,0,6,0,ITF,ITF6,18,Calabria
2021-02-13 00:00:00,SAR,1454,563,891,732,464,253,0,0,5,1452,2,ITG,ITG2,20,Sardegna
2021-01-15 00:00:00,CAM,4980,2381,2599,2740,2049,191,0,0,0,4980,0,ITF,ITF3,15,Campania
2021-01-01 00:00:00,SIC,815,437,378,740,75,0,0,0,0,815,0,ITG,ITG1,19,Sicilia
2021-03-15 00:00:00,CAM,13012,6124,6888,483,3821,85,5809,234,2580,8309,4703,ITF,ITF3,15,Campania
2021-02-06 00:00:00,PIE,7982,2664,5318,5100,1627,1255,0,0,0,400,7582,ITC,ITC1,1,Piemonte
2021-01-03 00:00:00,PAT,483,158,325,409,12,62,0,0,0,483,0,ITH,ITH2,4,Provincia Autonoma Trento
2021-02-03 00:00:00,CAM,8902,4002,4900,4735,3452,714,1,0,0,878,8024,ITF,ITF3,15,Campania
2021-02-06 00:00:00,SAR,1970,697,1273,1544,286,139,0,0,1,569,1401,ITG,ITG2,20,Sardegna
2021-02-20 00:00:00,MOL,1018,441,577,20,57,8,933,0,0,998,20,ITF,ITF2,14,Molise
2021-02-22 00:00:00,UMB,1858,777,1081,732,120,1,1005,0,0,1772,86,ITI,ITI2,10,Umbria
2021-03-16 00:00:00,PUG,9485,4521,4964,2161,819,75,6331,62,37,3168,6317,ITF,ITF4,16,Puglia
2021-01-04 00:00:00,PAT,853,223,630,481,49,322,1,0,0,853,0,ITH,ITH2,4,Provincia Autonoma Trento
2021-02-11 00:00:00,EMR,4244,1414,2830,2528,650,719,345,0,2,3406,838,ITH,ITH5,8,Emilia-Romagna
2021-01-02 00:00:00,ABR,548,218,330,540,8,0,0,0,0,548,0,ITF,ITF1,13,Abruzzo
2021-01-15 00:00:00,LOM,24418,7190,17228,13557,6189,4368,302,2,0,24418,0,ITC,ITC4,3,Lombardia
2021-03-17 00:00:00,LAZ,13265,5693,7572,1446,2313,230,9255,7,14,7127,6138,ITI,ITI4,12,Lazio
2020-12-27 00:00:00,TOS,620,267,353,460,147,13,0,0,0,620,0,ITI,ITI1,9,Toscana
2021-02-01 00:00:00,LIG,2440,904,1536,1912,212,315,0,0,1,76,2364,ITC,ITC3,7,Liguria
2021-03-12 00:00:00,SIC,12614,5399,7215,1378,4173,695,3764,341,2263,10392,2222,ITG,ITG1,19,Sicilia
2021-02-25 00:00:00,PAT,1585,621,964,120,16,32,1323,1,93,1127,458,ITH,ITH2,4,Provincia Autonoma Trento
2021-03-06 00:00:00,LAZ,17908,6878,11030,3651,1363,327,7863,932,3772,13655,4253,ITI,ITI4,12,Lazio
2021-01-06 00:00:00,FVG,709,264,445,514,195,0,0,0,0,709,0,ITH,ITH4,6,Friuli-Venezia Giulia
2021-02-06 00:00:00,ABR,1611,742,869,1168,371,72,0,0,0,602,1009,ITF,ITF1,13,Abruzzo
2021-02-27 00:00:00,SIC,12441,5567,6874,1513,2423,277,3838,1021,3369,11236,1205,ITG,ITG1,19,Sicilia
2021-01-31 00:00:00,VDA,290,90,200,231,41,18,0,0,0,58,232,ITC,ITC2,2,Valle d'Aosta / Vall√©e d'Aoste
2021-03-10 00:00:00,TOS,17421,6808,10613,2993,2187,204,11846,178,13,13459,3962,ITI,ITI1,9,Toscana
2021-02-15 00:00:00,MOL,144,70,74,117,12,15,0,0,0,141,3,ITF,ITF2,14,Molise
2021-02-04 00:00:00,VDA,294,86,208,168,91,34,1,0,0,8,286,ITC,ITC2,2,Valle d'Aosta / Vall√©e d'Aoste
2021-01-24 00:00:00,SAR,90,34,56,89,1,0,0,0,0,5,85,ITG,ITG2,20,Sardegna
2021-02-28 00:00:00,VDA,260,86,174,78,58,24,93,3,4,77,183,ITC,ITC2,2,Valle d'Aosta / Vall√©e d'Aoste
2021-01-13 00:00:00,BAS,916,387,529,699,68,148,0,0,1,916,0,ITF,ITF5,17,Basilicata
2021-02-14 00:00:00,PAT,246,186,60,246,0,0,0,0,0,11,235,ITH,ITH2,4,Provincia Autonoma Trento
2021-03-01 00:00:00,MOL,641,268,373,200,184,108,0,2,147,427,214,ITF,ITF2,14,Molise
2021-02-01 00:00:00,VDA,403,127,276,268,65,70,0,0,0,87,316,ITC,ITC2,2,Valle d'Aosta / Vall√©e d'Aoste
2021-03-14 00:00:00,PAB,754,336,418,130,37,33,553,1,0,25,729,ITH,ITH1,4,Provincia Autonoma Bolzano / Bozen
2021-01-24 00:00:00,PAB,12,10,2,1,11,0,0,0,0,0,12,ITH,ITH1,4,Provincia Autonoma Bolzano / Bozen
2021-02-17 00:00:00,PAB,4,1,3,1,2,0,1,0,0,2,2,ITH,ITH1,4,Provincia Autonoma Bolzano / Bozen
2021-01-03 00:00:00,CAL,6,3,3,4,2,0,0,0,0,6,0,ITF,ITF6,18,Calabria
2021-03-08 00:00:00,MAR,6170,2661,3509,768,535,219,3101,533,1014,5168,1002,ITI,ITI3,11,Marche
2021-03-05 00:00:00,VEN,13127,4889,8238,3430,1996,1384,3090,275,2952,9544,3583,ITH,ITH3,5,Veneto
2021-03-12 00:00:00,TOS,15969,5957,10012,2604,1933,176,6681,650,3925,12458,3511,ITI,ITI1,9,Toscana
2021-02-28 00:00:00,PAT,242,121,121,231,0,0,0,0,11,242,0,ITH,ITH2,4,Provincia Autonoma Trento
2021-03-13 00:00:00,MOL,1189,594,595,29,1004,5,0,151,0,200,989,ITF,ITF2,14,Molise
2021-02-01 00:00:00,MAR,1365,480,885,1057,227,81,0,0,0,98,1267,ITI,ITI3,11,Marche
2021-02-15 00:00:00,LAZ,7726,3379,4347,2447,675,378,4218,8,0,7429,297,ITI,ITI4,12,Lazio
2021-03-14 00:00:00,LIG,1648,747,901,64,383,176,567,27,431,1044,604,ITC,ITC3,7,Liguria
2021-01-12 00:00:00,SIC,4542,2234,2308,2863,1484,195,0,0,0,4542,0,ITG,ITG1,19,Sicilia
2021-01-21 00:00:00,LAZ,5247,2109,3138,4780,110,232,125,0,0,196,5051,ITI,ITI4,12,Lazio
2021-02-13 00:00:00,LOM,6379,2430,3949,4172,1500,682,17,4,4,4930,1449,ITC,ITC4,3,Lombardia
2021-01-31 00:00:00,CAM,8067,3711,4356,5107,2893,67,0,0,0,23,8044,ITF,ITF3,15,Campania
2021-02-03 00:00:00,SAR,1118,418,700,919,180,19,0,0,0,426,692,ITG,ITG2,20,Sardegna
2021-01-30 00:00:00,SAR,3862,1392,2470,2987,874,0,1,0,0,362,3500,ITG,ITG2,20,Sardegna
2021-03-13 00:00:00,FVG,2836,1096,1740,10,15,86,2056,37,632,1565,1271,ITH,ITH4,6,Friuli-Venezia Giulia
2021-01-05 00:00:00,SIC,10527,5159,5368,9074,1246,207,0,0,0,10527,0,ITG,ITG1,19,Sicilia
2021-03-10 00:00:00,PUG,14067,6085,7982,2553,1242,355,6257,584,3076,10957,3110,ITF,ITF4,16,Puglia
2021-02-15 00:00:00,FVG,2451,909,1542,698,405,314,1034,0,0,2201,250,ITH,ITH4,6,Friuli-Venezia Giulia
2021-01-28 00:00:00,EMR,10220,3333,6887,8068,1030,1122,0,0,0,348,9872,ITH,ITH5,8,Emilia-Romagna
2020-12-31 00:00:00,SIC,877,469,408,827,50,0,0,0,0,877,0,ITG,ITG1,19,Sicilia
2021-01-29 00:00:00,MAR,1991,730,1261,1479,438,74,0,0,0,168,1823,ITI,ITI3,11,Marche
2021-01-08 00:00:00,SIC,8328,3864,4464,6591,1524,213,0,0,0,8328,0,ITG,ITG1,19,Sicilia
2021-02-02 00:00:00,LAZ,5772,2133,3639,4712,486,571,3,0,0,501,5271,ITI,ITI4,12,Lazio
2021-03-03 00:00:00,EMR,15645,5177,10468,2525,1048,160,6797,340,4775,13203,2442,ITH,ITH5,8,Emilia-Romagna
2021-03-08 00:00:00,VEN,13339,6044,7295,699,1184,383,7147,986,2940,9300,4039,ITH,ITH3,5,Veneto
2021-02-01 00:00:00,CAM,3985,1813,2172,2504,1329,152,0,0,0,110,3875,ITF,ITF3,15,Campania
2021-02-02 00:00:00,BAS,366,142,224,212,51,102,1,0,0,176,190,ITF,ITF5,17,Basilicata
2021-01-11 00:00:00,VEN,7237,2100,5137,3499,1530,1956,247,0,5,7237,0,ITH,ITH3,5,Veneto
2021-01-15 00:00:00,VEN,5870,1820,4050,2991,1299,1565,9,3,3,5870,0,ITH,ITH3,5,Veneto
2021-03-15 00:00:00,PIE,10478,4118,6360,1714,1501,225,5689,0,1349,4869,5609,ITC,ITC1,1,Piemonte
2021-01-03 00:00:00,SAR,90,36,54,89,1,0,0,0,0,90,0,ITG,ITG2,20,Sardegna
2021-02-23 00:00:00,PAB,763,320,443,0,58,0,621,0,84,758,5,ITH,ITH1,4,Provincia Autonoma Bolzano / Bozen
2021-03-02 00:00:00,MOL,666,383,283,98,253,51,0,113,151,508,158,ITF,ITF2,14,Molise
2021-01-21 00:00:00,UMB,610,202,408,428,13,169,0,0,0,341,269,ITI,ITI2,10,Umbria
2020-12-27 00:00:00,UMB,85,45,40,67,2,16,0,0,0,85,0,ITI,ITI2,10,Umbria
2020-12-27 00:00:00,LAZ,272,131,141,272,0,0,0,0,0,272,0,ITI,ITI4,12,Lazio
